id,name,loaning_club,player_value_in_moment_of_transfer,transfer_cost,league,year,market_value_in_eur,delta_value
536835,Amad Diallo,AFC Sunderland,15000000,Wypożyczenie,GB2,2022,13000000,-2000000
668268,Marquinhos,Norwich City,10000000,Wypożyczenie,GB2,2022,12000000,2000000
283514,Alex Mowatt,FC Middlesbrough,10000000,Wypożyczenie,GB2,2022,4000000,-6000000
533662,Cameron Archer,FC Middlesbrough,8000000,Wypożyczenie,GB2,2022,10000000,2000000
533662,Cameron Archer,Preston North End,500000,Wypożyczenie,GB2,2021,10000000,9500000
296986,Tyler Roberts,Queens Park Rangers,8000000,Wypożyczenie,GB2,2022,4000000,-4000000
206225,Isaac Hayden,Norwich City,8000000,Wypożyczenie,GB2,2022,4000000,-4000000
503980,Joe Gelhardt,AFC Sunderland,8000000,Wypożyczenie,GB2,2022,8000000,0
668228,Matheus Martins,FC Watford,7000000,Wypożyczenie,GB2,2022,7000000,0
610849,Liam Delap,Preston North End,7000000,Wypożyczenie,GB2,2022,7000000,0
610849,Liam Delap,Stoke City,1000000,Wypożyczenie,GB2,2022,7000000,6000000
503977,Taylor Harwood-Bellis,FC Burnley,7000000,Wypożyczenie,GB2,2022,15000000,8000000
503977,Taylor Harwood-Bellis,Stoke City,3000000,Wypożyczenie,GB2,2021,15000000,12000000
503977,Taylor Harwood-Bellis,Blackburn Rovers,2000000,Wypożyczenie,GB2,2020,15000000,13000000
607224,Hannibal,Birmingham City,6000000,Wypożyczenie,GB2,2022,8000000,2000000
221624,Zack Steffen,FC Middlesbrough,6000000,Wypożyczenie,GB2,2022,4000000,-2000000
342046,Axel Tuanzebe,Stoke City,6000000,Wypożyczenie,GB2,2022,6000000,0
342046,Axel Tuanzebe,Aston Villa,1000000,Wypożyczenie,GB2,2018,6000000,5000000
485585,Ian Maatsen,FC Burnley,5000000,Wypożyczenie,GB2,2022,9000000,4000000
485585,Ian Maatsen,Coventry City,0,Wypożyczenie,GB2,2021,9000000,9000000
485585,Ian Maatsen,Charlton Athletic,0,Wypożyczenie,GB3,2020,9000000,9000000
475416,Sorba Thomas,Blackburn Rovers,5000000,Wypożyczenie,GB2,2022,5000000,0
324882,Marvelous Nakamba,Luton Town,5000000,Wypożyczenie,GB2,2022,4000000,-1000000
531679,Ethan Laird,Queens Park Rangers,5000000,Wypożyczenie,GB2,2022,5000000,0
531679,Ethan Laird,AFC Bournemouth,5000000,Wypożyczenie,GB2,2021,5000000,0
531679,Ethan Laird,Swansea City,1000000,Wypożyczenie,GB2,2021,5000000,4000000
531679,Ethan Laird,Milton Keynes Dons,1000000,Wypożyczenie,GB3,2020,5000000,4000000
148262,Jeff Hendrick,FC Reading,5000000,Wypożyczenie,GB2,2022,2000000,-3000000
148262,Jeff Hendrick,Queens Park Rangers,7000000,Wypożyczenie,GB2,2021,2000000,-5000000
434207,Aaron Connolly,Hull City,5000000,Wypożyczenie,GB2,2022,5000000,0
434207,Aaron Connolly,FC Middlesbrough,7000000,Wypożyczenie,GB2,2021,5000000,-2000000
434207,Aaron Connolly,Luton Town,0,Wypożyczenie,GB3,2018,5000000,5000000
617267,Henrique Araújo,FC Watford,5000000,Wypożyczenie,GB2,2022,5000000,0
735571,Rodrigo Muniz,FC Middlesbrough,5000000,Wypożyczenie,GB2,2022,5000000,0
552655,Troy Parrott,Preston North End,5000000,Wypożyczenie,GB2,2022,4000000,-1000000
552655,Troy Parrott,Milton Keynes Dons,3000000,Wypożyczenie,GB3,2021,4000000,1000000
552655,Troy Parrott,FC Millwall,3000000,Wypożyczenie,GB2,2020,4000000,1000000
552655,Troy Parrott,Ipswich Town,3000000,Wypożyczenie,GB3,2020,4000000,1000000
403898,Jordan Beyer,FC Burnley,4000000,Wypożyczenie,GB2,2022,10000000,6000000
212832,Dimitrios Pelkas,Hull City,4000000,Wypożyczenie,GB2,2022,3000000,-1000000
364237,Mamadou Loum,FC Reading,4000000,Wypożyczenie,GB2,2022,3000000,-1000000
485583,Ki-Jana Hoever,Stoke City,4000000,Wypożyczenie,GB2,2022,4000000,0
233124,Kortney Hause,FC Watford,4000000,Wypożyczenie,GB2,2022,2000000,-2000000
233124,Kortney Hause,Aston Villa,1000000,Wypożyczenie,GB2,2018,2000000,1000000
287247,Krystian Bielik,Birmingham City,4000000,Wypożyczenie,GB2,2022,3000000,-1000000
287247,Krystian Bielik,Charlton Athletic,2000000,Wypożyczenie,GB3,2018,3000000,1000000
444208,Michael Obafemi,FC Burnley,4000000,Wypożyczenie,GB2,2022,4000000,0
341501,Hamza Choudhury,FC Watford,4000000,Wypożyczenie,GB2,2022,5000000,1000000
290017,Hassane Kamara,FC Watford,4000000,Wypożyczenie,GB2,2022,8000000,4000000
503679,Rhys Williams,FC Blackpool,4000000,Wypożyczenie,GB2,2022,3000000,-1000000
503679,Rhys Williams,Swansea City,5000000,Wypożyczenie,GB2,2021,3000000,-2000000
435062,Callum Styles,FC Millwall,3000000,Wypożyczenie,GB2,2022,3000000,0
435062,Callum Styles,FC Bury,250000,Wypożyczenie,GB4,2018,3000000,2750000
433181,Tino Anjorin,Huddersfield Town,3000000,Wypożyczenie,GB2,2022,2000000,-1000000
433181,Tino Anjorin,Huddersfield Town,3000000,Wypożyczenie,GB2,2021,2000000,-1000000
583199,James McAtee,Sheffield United,3000000,Wypożyczenie,GB2,2022,6000000,3000000
465606,Halil Dervisoglu,FC Burnley,3000000,Wypożyczenie,GB2,2022,2000000,-1000000
597659,Charlie Cresswell,FC Millwall,3000000,Wypożyczenie,GB2,2022,5000000,2000000
531957,Cody Drameh,Luton Town,3000000,Wypożyczenie,GB2,2022,3000000,0
531957,Cody Drameh,Cardiff City,1000000,Wypożyczenie,GB2,2021,3000000,2000000
512354,Malcolm Ebiowei,Hull City,3000000,Wypożyczenie,GB2,2022,3000000,0
618494,Tyler Morton,Blackburn Rovers,3000000,Wypożyczenie,GB2,2022,7000000,4000000
659521,Edouard Michut,AFC Sunderland,3000000,Wypożyczenie,GB2,2022,2000000,-1000000
665390,Jaden Philogene,Cardiff City,3000000,Wypożyczenie,GB2,2022,2000000,-1000000
665390,Jaden Philogene,Stoke City,500000,Wypożyczenie,GB2,2021,2000000,1500000
504581,Ryan Giles,FC Middlesbrough,3000000,Wypożyczenie,GB2,2022,7000000,4000000
504581,Ryan Giles,Blackburn Rovers,2000000,Wypożyczenie,GB2,2021,7000000,5000000
504581,Ryan Giles,Cardiff City,1000000,Wypożyczenie,GB2,2021,7000000,6000000
504581,Ryan Giles,Rotherham United,1000000,Wypożyczenie,GB2,2020,7000000,6000000
504581,Ryan Giles,Coventry City,0,Wypożyczenie,GB2,2020,7000000,7000000
504581,Ryan Giles,Coventry City,0,Wypożyczenie,GB3,2019,7000000,7000000
504581,Ryan Giles,Shrewsbury Town,0,Wypożyczenie,GB3,2019,7000000,7000000
341317,Oliver Burke,FC Millwall,3000000,Wypożyczenie,GB2,2022,3000000,0
341317,Oliver Burke,FC Millwall,5000000,Wypożyczenie,GB2,2021,3000000,-2000000
229695,Bersant Celina,Stoke City,3000000,Wypożyczenie,GB2,2022,3000000,0
229695,Bersant Celina,Ipswich Town,3000000,Wypożyczenie,GB3,2021,3000000,0
646658,Aaron Ramsey,FC Middlesbrough,3000000,Wypożyczenie,GB2,2022,5000000,2000000
646658,Aaron Ramsey,Norwich City,1000000,Wypożyczenie,GB2,2022,5000000,4000000
646658,Aaron Ramsey,Cheltenham Town,1000000,Wypożyczenie,GB3,2021,5000000,4000000
534700,Jamie Shackleton,FC Millwall,2000000,Wypożyczenie,GB2,2022,2000000,0
392777,Jonathan Panzo,Coventry City,2000000,Wypożyczenie,GB2,2022,3000000,1000000
433183,Tommy Doyle,Sheffield United,2000000,Wypożyczenie,GB2,2022,5000000,3000000
433183,Tommy Doyle,Cardiff City,1000000,Wypożyczenie,GB2,2021,5000000,4000000
696589,Tim Iroegbunam,Queens Park Rangers,2000000,Wypożyczenie,GB2,2022,4000000,2000000
355689,Sory Kaba,Cardiff City,2000000,Wypożyczenie,GB2,2022,2000000,0
183302,Ben Pearson,Stoke City,2000000,Wypożyczenie,GB2,2022,2000000,0
412660,Keinan Davis,FC Watford,2000000,Wypożyczenie,GB2,2022,3000000,1000000
412660,Keinan Davis,Nottingham Forest,3000000,Wypożyczenie,GB2,2021,3000000,0
591193,Niels Nkounkou,Cardiff City,2000000,Wypożyczenie,GB2,2022,3000000,1000000
224884,Abdul-Rahman Baba,FC Reading,2000000,Wypożyczenie,GB2,2022,1000000,-1000000
224884,Abdul-Rahman Baba,FC Reading,2000000,Wypożyczenie,GB2,2021,1000000,-1000000
249873,Tariqe Fosu,Stoke City,2000000,Wypożyczenie,GB2,2022,2000000,0
249873,Tariqe Fosu,Rotherham United,2000000,Wypożyczenie,GB2,2022,2000000,0
392763,Ian Poveda,FC Blackpool,2000000,Wypożyczenie,GB2,2022,1000000,-1000000
392763,Ian Poveda,Blackburn Rovers,1000000,Wypożyczenie,GB2,2021,1000000,0
811778,Álvaro Fernandez,Preston North End,2000000,Wypożyczenie,GB2,2022,6000000,4000000
61560,Marc Albrighton,West Bromwich Albion,2000000,Wypożyczenie,GB2,2022,2000000,0
293257,Matija Sarkic,Stoke City,2000000,Wypożyczenie,GB2,2022,2000000,0
293257,Matija Sarkic,Birmingham City,100000,Wypożyczenie,GB2,2021,2000000,1900000
293257,Matija Sarkic,Shrewsbury Town,100000,Wypożyczenie,GB3,2020,2000000,1900000
389253,Auston Trusty,Birmingham City,2000000,Wypożyczenie,GB2,2022,9000000,7000000
581674,Charlie Patino,FC Blackpool,2000000,Wypożyczenie,GB2,2022,8000000,6000000
506470,Josh Bowler,FC Blackpool,2000000,Wypożyczenie,GB2,2022,2000000,0
506470,Josh Bowler,Hull City,0,Wypożyczenie,GB2,2019,2000000,2000000
444211,Will Smallbone,Stoke City,2000000,Wypożyczenie,GB2,2022,2000000,0
99397,Karl Darlow,Hull City,1000000,Wypożyczenie,GB2,2022,1000000,0
340322,Nathan Tella,FC Burnley,1000000,Wypożyczenie,GB2,2022,12000000,11000000
503743,Morgan Rogers,FC Blackpool,1000000,Wypożyczenie,GB2,2022,1000000,0
503743,Morgan Rogers,AFC Bournemouth,1000000,Wypożyczenie,GB2,2021,1000000,0
503743,Morgan Rogers,Lincoln City,1000000,Wypożyczenie,GB3,2020,1000000,0
391719,Domingos Quina,Rotherham United,1000000,Wypożyczenie,GB2,2022,1000000,0
391719,Domingos Quina,FC Fulham,3000000,Wypożyczenie,GB2,2021,1000000,-2000000
391719,Domingos Quina,FC Barnsley,2000000,Wypożyczenie,GB2,2021,1000000,-1000000
98240,Ciaran Clark,Sheffield United,1000000,Wypożyczenie,GB2,2022,700000,-300000
383109,Przemyslaw Placheta,Birmingham City,1000000,Wypożyczenie,GB2,2022,2000000,1000000
346499,Danel Sinani,Wigan Athletic,1000000,Wypożyczenie,GB2,2022,1000000,0
346499,Danel Sinani,Huddersfield Town,550000,Wypożyczenie,GB2,2021,1000000,450000
239949,Jamal Lowe,Queens Park Rangers,1000000,Wypożyczenie,GB2,2022,1000000,0
469064,Gavin Kilkenny,Stoke City,1000000,Wypożyczenie,GB2,2022,500000,-500000
469064,Gavin Kilkenny,Charlton Athletic,700000,Wypożyczenie,GB3,2022,500000,-200000
289846,Ashley Fletcher,Wigan Athletic,1000000,Wypożyczenie,GB2,2022,800000,-200000
149237,Anthony Knockaert,Huddersfield Town,1000000,Wypożyczenie,GB2,2022,1000000,0
149237,Anthony Knockaert,Nottingham Forest,5000000,Wypożyczenie,GB2,2020,1000000,-4000000
728733,Brooke Norton-Cuffy,Coventry City,1000000,Wypożyczenie,GB2,2022,1000000,0
728733,Brooke Norton-Cuffy,Rotherham United,400000,Wypożyczenie,GB2,2022,1000000,600000
728733,Brooke Norton-Cuffy,Lincoln City,0,Wypożyczenie,GB3,2021,1000000,1000000
124845,Grant Hall,Rotherham United,1000000,Wypożyczenie,GB2,2022,900000,-100000
470594,Clinton Mola,Blackburn Rovers,1000000,Wypożyczenie,GB2,2022,800000,-200000
622380,Cesare Casadei,FC Reading,1000000,Wypożyczenie,GB2,2022,6000000,5000000
568535,Theo Corbeanu,FC Blackpool,1000000,Wypożyczenie,GB2,2022,1000000,0
568535,Theo Corbeanu,Milton Keynes Dons,1000000,Wypożyczenie,GB3,2021,1000000,0
568535,Theo Corbeanu,Sheffield Wednesday,500000,Wypożyczenie,GB3,2021,1000000,500000
346315,Dujon Sterling,Stoke City,1000000,Wypożyczenie,GB2,2022,800000,-200000
346315,Dujon Sterling,FC Blackpool,900000,Wypożyczenie,GB2,2021,800000,-100000
346315,Dujon Sterling,Wigan Athletic,0,Wypożyczenie,GB2,2019,800000,800000
346315,Dujon Sterling,Coventry City,0,Wypożyczenie,GB3,2018,800000,800000
419025,Conor Coventry,Rotherham United,1000000,Wypożyczenie,GB2,2022,1000000,0
419025,Conor Coventry,Peterborough United,200000,Wypożyczenie,GB2,2021,1000000,800000
419025,Conor Coventry,Milton Keynes Dons,300000,Wypożyczenie,GB3,2021,1000000,700000
419025,Conor Coventry,Lincoln City,0,Wypożyczenie,GB3,2019,1000000,1000000
336367,Joe Lumley,FC Reading,1000000,Wypożyczenie,GB2,2022,1000000,0
336367,Joe Lumley,Doncaster Rovers,600000,Wypożyczenie,GB3,2020,1000000,400000
336367,Joe Lumley,FC Gillingham,600000,Wypożyczenie,GB3,2020,1000000,400000
405686,Reda Khadra,Birmingham City,1000000,Wypożyczenie,GB2,2022,1000000,0
405686,Reda Khadra,Sheffield United,1000000,Wypożyczenie,GB2,2022,1000000,0
405686,Reda Khadra,Blackburn Rovers,150000,Wypożyczenie,GB2,2021,1000000,850000
576121,Josh Wilson-Esbrand,Coventry City,1000000,Wypożyczenie,GB2,2022,1000000,0
535927,Luke McNally,Coventry City,900000,Wypożyczenie,GB2,2022,900000,0
532541,Luke Cundle,Swansea City,800000,Wypożyczenie,GB2,2022,1000000,200000
571821,Christ Tiehi,Wigan Athletic,800000,Wypożyczenie,GB2,2022,1000000,200000
547533,Miguel Azeez,Wigan Athletic,800000,Wypożyczenie,GB2,2022,800000,0
547533,Miguel Azeez,FC Portsmouth,500000,Wypożyczenie,GB3,2021,800000,300000
420808,George Hirst,Blackburn Rovers,800000,Wypożyczenie,GB2,2022,800000,0
420808,George Hirst,Ipswich Town,800000,Wypożyczenie,GB3,2022,800000,0
420808,George Hirst,FC Portsmouth,800000,Wypożyczenie,GB3,2021,800000,0
420808,George Hirst,Rotherham United,450000,Wypożyczenie,GB2,2020,800000,350000
364827,Cédric Kipré,Cardiff City,800000,Wypożyczenie,GB2,2022,1000000,200000
242284,Ethan Horvath,Luton Town,800000,Wypożyczenie,GB2,2022,1000000,200000
661208,Leo Fuhr Hjelde,Rotherham United,800000,Wypożyczenie,GB2,2022,1000000,200000
578292,Omar Rekik,Wigan Athletic,800000,Wypożyczenie,GB2,2022,600000,-200000
728982,Scott High,Rotherham United,800000,Wypożyczenie,GB2,2022,900000,100000
728982,Scott High,Shrewsbury Town,0,Wypożyczenie,GB3,2020,900000,900000
376856,Charlie Goode,FC Blackpool,800000,Wypożyczenie,GB2,2022,800000,0
376856,Charlie Goode,Sheffield United,1000000,Wypożyczenie,GB2,2021,800000,-200000
376856,Charlie Goode,Northampton Town,100000,Wypożyczenie,GB4,2018,800000,700000
147419,Bailey Wright,Rotherham United,700000,Wypożyczenie,GB2,2022,700000,0
147419,Bailey Wright,AFC Sunderland,1000000,Wypożyczenie,GB3,2019,700000,-300000
511550,Ellis Simms,AFC Sunderland,600000,Wypożyczenie,GB2,2022,4000000,3400000
511550,Ellis Simms,FC Blackpool,0,Wypożyczenie,GB3,2020,4000000,4000000
609883,Luke Mbete,Huddersfield Town,600000,Wypożyczenie,GB2,2022,2000000,1400000
609883,Luke Mbete,Bolton Wanderers,2000000,Wypożyczenie,GB3,2022,2000000,0
689893,Rarmani Edmonds-Green,Wigan Athletic,600000,Wypożyczenie,GB2,2022,500000,-100000
689893,Rarmani Edmonds-Green,Rotherham United,500000,Wypożyczenie,GB3,2021,500000,0
689893,Rarmani Edmonds-Green,Swindon Town,150000,Wypożyczenie,GB4,2019,500000,350000
495993,Dion Sanderson,Birmingham City,600000,Wypożyczenie,GB2,2022,3000000,2400000
495993,Dion Sanderson,Queens Park Rangers,300000,Wypożyczenie,GB2,2021,3000000,2700000
495993,Dion Sanderson,Birmingham City,150000,Wypożyczenie,GB2,2021,3000000,2850000
495993,Dion Sanderson,AFC Sunderland,150000,Wypożyczenie,GB3,2020,3000000,2850000
495993,Dion Sanderson,Cardiff City,0,Wypożyczenie,GB2,2019,3000000,3000000
566802,Lewis Fiorini,FC Blackpool,600000,Wypożyczenie,GB2,2022,1000000,400000
566802,Lewis Fiorini,Lincoln City,400000,Wypożyczenie,GB3,2021,1000000,600000
817688,Callum Doyle,Coventry City,600000,Wypożyczenie,GB2,2022,5000000,4400000
817688,Callum Doyle,AFC Sunderland,0,Wypożyczenie,GB3,2021,5000000,5000000
344009,Nathan Broadhead,Wigan Athletic,500000,Wypożyczenie,GB2,2022,700000,200000
344009,Nathan Broadhead,AFC Sunderland,500000,Wypożyczenie,GB3,2021,700000,200000
344009,Nathan Broadhead,Burton Albion,0,Wypożyczenie,GB3,2019,700000,700000
725703,Joseph Hungbo,Huddersfield Town,450000,Wypożyczenie,GB2,2022,450000,0
484551,Taylor Richards,Queens Park Rangers,400000,Wypożyczenie,GB2,2022,400000,0
484551,Taylor Richards,Birmingham City,400000,Wypożyczenie,GB2,2021,400000,0
484551,Taylor Richards,Doncaster Rovers,0,Wypożyczenie,GB3,2020,400000,400000
581675,Harvey Vale,Hull City,400000,Wypożyczenie,GB2,2022,2000000,1600000
587019,Fin Stevens,Swansea City,400000,Wypożyczenie,GB2,2022,400000,0
102258,Matthew Lowton,Huddersfield Town,400000,Wypożyczenie,GB2,2022,400000,0
528892,Harry Clarke,Stoke City,350000,Wypożyczenie,GB2,2022,600000,250000
528892,Harry Clarke,Oldham Athletic,0,Wypożyczenie,GB4,2020,600000,600000
690478,Matthew Sorinola,Swansea City,350000,Wypożyczenie,GB2,2022,800000,450000
452707,Jordan Smith,Huddersfield Town,300000,Wypożyczenie,GB2,2022,300000,0
452707,Jordan Smith,FC Barnsley,250000,Wypożyczenie,GB3,2018,300000,50000
452707,Jordan Smith,Mansfield Town,250000,Wypożyczenie,GB4,2018,300000,50000
626888,Kaine Kesler-Hayden,Huddersfield Town,300000,Wypożyczenie,GB2,2022,1000000,700000
626888,Kaine Kesler-Hayden,Milton Keynes Dons,250000,Wypożyczenie,GB3,2021,1000000,750000
626888,Kaine Kesler-Hayden,Swindon Town,250000,Wypożyczenie,GB4,2021,1000000,750000
599739,Xavier Simons,Hull City,300000,Wypożyczenie,GB2,2022,500000,200000
61674,Martyn Waghorn,Huddersfield Town,300000,Wypożyczenie,GB2,2022,300000,0
504386,Emmanuel Longelo,Birmingham City,150000,Wypożyczenie,GB2,2022,800000,650000
503918,Tyrese Fornah,FC Reading,0,Wypożyczenie,GB2,2022,700000,700000
503918,Tyrese Fornah,Shrewsbury Town,0,Wypożyczenie,GB3,2021,700000,700000
503918,Tyrese Fornah,Plymouth Argyle,0,Wypożyczenie,GB3,2020,700000,700000
559330,Salah-Eddine Oulad M'Hand,Hull City,0,Wypożyczenie,GB2,2022,800000,800000
669366,Thomas Cannon,Preston North End,0,Wypożyczenie,GB2,2022,3000000,3000000
724529,Tayo Adaramola,Coventry City,0,Wypożyczenie,GB2,2022,1000000,1000000
531461,Armstrong Oko-Flex,Swansea City,0,Wypożyczenie,GB2,2022,500000,500000
640026,Shola Shoretire,Bolton Wanderers,4000000,Wypożyczenie,GB3,2022,4000000,0
531677,Di'Shon Bernard,FC Portsmouth,3000000,Wypożyczenie,GB3,2022,2000000,-1000000
531677,Di'Shon Bernard,Hull City,1000000,Wypożyczenie,GB2,2021,2000000,1000000
531677,Di'Shon Bernard,Salford City,1000000,Wypożyczenie,GB4,2020,2000000,1000000
430788,Tom Edwards,FC Barnsley,2000000,Wypożyczenie,GB3,2022,1000000,-1000000
430788,Tom Edwards,Fleetwood Town,1000000,Wypożyczenie,GB3,2020,1000000,0
429578,Josh Koroma,FC Portsmouth,2000000,Wypożyczenie,GB3,2022,1000000,-1000000
429578,Josh Koroma,Rotherham United,150000,Wypożyczenie,GB3,2019,1000000,850000
406558,Steven Sessegnon,Charlton Athletic,1000000,Wypożyczenie,GB3,2022,500000,-500000
406558,Steven Sessegnon,Plymouth Argyle,1000000,Wypożyczenie,GB3,2021,500000,-500000
406558,Steven Sessegnon,Bristol City,2000000,Wypożyczenie,GB2,2020,500000,-1500000
561454,Mark McGuinness,Sheffield Wednesday,1000000,Wypożyczenie,GB3,2022,3000000,2000000
561454,Mark McGuinness,Ipswich Town,0,Wypożyczenie,GB3,2020,3000000,3000000
346482,Dan N'Lundulu,Cheltenham Town,1000000,Wypożyczenie,GB3,2022,900000,-100000
346482,Dan N'Lundulu,Bolton Wanderers,1000000,Wypożyczenie,GB3,2022,900000,-100000
346482,Dan N'Lundulu,Cheltenham Town,1000000,Wypożyczenie,GB3,2021,900000,-100000
346482,Dan N'Lundulu,Lincoln City,1000000,Wypożyczenie,GB3,2021,900000,-100000
587002,Myles Peart-Harris,Forest Green Rovers,1000000,Wypożyczenie,GB3,2022,700000,-300000
587003,Lewis Bate,Oxford United,1000000,Wypożyczenie,GB3,2022,1000000,0
581670,Louie Barry,Milton Keynes Dons,1000000,Wypożyczenie,GB3,2022,1000000,0
581670,Louie Barry,Salford City,1000000,Wypożyczenie,GB4,2022,1000000,0
581670,Louie Barry,Ipswich Town,1000000,Wypożyczenie,GB3,2021,1000000,0
581670,Louie Barry,Swindon Town,1000000,Wypożyczenie,GB4,2021,1000000,0
351691,Sam Cosgrove,Plymouth Argyle,1000000,Wypożyczenie,GB3,2022,700000,-300000
351691,Sam Cosgrove,AFC Wimbledon,1000000,Wypożyczenie,GB3,2021,700000,-300000
351691,Sam Cosgrove,Shrewsbury Town,1000000,Wypożyczenie,GB3,2021,700000,-300000
502075,Morgan Whittaker,Plymouth Argyle,1000000,Wypożyczenie,GB3,2022,1000000,0
502075,Morgan Whittaker,Lincoln City,1000000,Wypożyczenie,GB3,2021,1000000,0
624258,Conor Bradley,Bolton Wanderers,1000000,Wypożyczenie,GB3,2022,1000000,0
503976,Dynel Simeu,FC Morecambe,1000000,Wypożyczenie,GB3,2022,800000,-200000
503976,Dynel Simeu,Tranmere Rovers,1000000,Wypożyczenie,GB4,2022,800000,-200000
503976,Dynel Simeu,Carlisle United,1000000,Wypożyczenie,GB4,2021,800000,-200000
406637,Tashan Oakley-Boothe,Lincoln City,900000,Wypożyczenie,GB3,2022,350000,-550000
580765,Henry Lawrence,Milton Keynes Dons,800000,Wypożyczenie,GB3,2022,600000,-200000
580765,Henry Lawrence,AFC Wimbledon,0,Wypożyczenie,GB3,2021,600000,600000
503768,Tyreece John-Jules,Ipswich Town,800000,Wypożyczenie,GB3,2022,800000,0
503768,Tyreece John-Jules,FC Blackpool,0,Wypożyczenie,GB2,2021,800000,800000
503768,Tyreece John-Jules,Sheffield Wednesday,700000,Wypożyczenie,GB3,2021,800000,100000
503768,Tyreece John-Jules,Doncaster Rovers,0,Wypożyczenie,GB3,2020,800000,800000
503768,Tyreece John-Jules,Lincoln City,0,Wypożyczenie,GB3,2019,800000,800000
456877,Rekeem Harper,Exeter City,800000,Wypożyczenie,GB3,2022,450000,-350000
456877,Rekeem Harper,Crewe Alexandra,2000000,Wypożyczenie,GB3,2021,450000,-1550000
456877,Rekeem Harper,Birmingham City,2000000,Wypożyczenie,GB2,2020,450000,-1550000
547534,Josh Martin,FC Barnsley,800000,Wypożyczenie,GB3,2022,700000,-100000
547534,Josh Martin,Milton Keynes Dons,1000000,Wypożyczenie,GB3,2021,700000,-300000
547534,Josh Martin,Doncaster Rovers,1000000,Wypożyczenie,GB3,2021,700000,-300000
314280,Taylor Moore,Shrewsbury Town,800000,Wypożyczenie,GB3,2022,500000,-300000
314280,Taylor Moore,FC Blackpool,1000000,Wypożyczenie,GB3,2019,500000,-500000
314280,Taylor Moore,Southend United,500000,Wypożyczenie,GB3,2018,500000,0
505652,Slobodan Tedic,FC Barnsley,750000,Wypożyczenie,GB3,2022,600000,-150000
686837,Charlie Savage,Forest Green Rovers,600000,Wypożyczenie,GB3,2022,600000,0
461559,Jordon Garrick,Lincoln City,600000,Wypożyczenie,GB3,2022,450000,-150000
461559,Jordon Garrick,Plymouth Argyle,250000,Wypożyczenie,GB3,2021,450000,200000
461559,Jordon Garrick,Swindon Town,250000,Wypożyczenie,GB3,2020,450000,200000
245585,Reece James,Sheffield Wednesday,600000,Wypożyczenie,GB3,2022,500000,-100000
586986,Luke Plange,Lincoln City,600000,Wypożyczenie,GB3,2022,1000000,400000
586986,Luke Plange,Derby County,0,Wypożyczenie,GB2,2021,1000000,1000000
581598,Harvey White,Derby County,600000,Wypożyczenie,GB3,2022,600000,0
581598,Harvey White,FC Portsmouth,0,Wypożyczenie,GB3,2020,600000,600000
105324,Aden Flint,Sheffield Wednesday,600000,Wypożyczenie,GB3,2022,450000,-150000
105324,Aden Flint,Sheffield Wednesday,3000000,Wypożyczenie,GB2,2020,450000,-2550000
503988,Alex Mighten,Sheffield Wednesday,600000,Wypożyczenie,GB3,2022,600000,0
67237,Matty Taylor,Port Vale FC,600000,Wypożyczenie,GB3,2022,400000,-200000
67237,Matty Taylor,Oxford United,750000,Wypożyczenie,GB3,2019,400000,-350000
696346,Jay Stansfield,Exeter City,500000,Wypożyczenie,GB3,2022,1000000,500000
614603,Chem Campbell,Wycombe Wanderers,500000,Wypożyczenie,GB3,2022,1000000,500000
169625,Carl Winchester,Shrewsbury Town,500000,Wypożyczenie,GB3,2022,500000,0
433168,Nathanael Ogbeta,Peterborough United,500000,Wypożyczenie,GB3,2022,500000,0
398063,Luke Southwood,Cheltenham Town,500000,Wypożyczenie,GB3,2022,500000,0
646727,Josh Coburn,Bristol Rovers,500000,Wypożyczenie,GB3,2022,700000,200000
586834,Jesurun Rak-Sakyi,Charlton Athletic,500000,Wypożyczenie,GB3,2022,1000000,500000
614082,Liam McCarron,Port Vale FC,500000,Wypożyczenie,GB3,2022,350000,-150000
533523,Haydon Roberts,Derby County,500000,Wypożyczenie,GB3,2022,500000,0
533523,Haydon Roberts,AFC Rochdale,0,Wypożyczenie,GB3,2020,500000,500000
565979,Josh Griffiths,FC Portsmouth,500000,Wypożyczenie,GB3,2022,1000000,500000
565979,Josh Griffiths,Lincoln City,500000,Wypożyczenie,GB3,2021,1000000,500000
565979,Josh Griffiths,Cheltenham Town,0,Wypożyczenie,GB4,2020,1000000,1000000
419325,Lewis Gibson,Bristol Rovers,500000,Wypożyczenie,GB3,2022,500000,0
419325,Lewis Gibson,Sheffield Wednesday,500000,Wypożyczenie,GB3,2021,500000,0
419325,Lewis Gibson,FC Reading,0,Wypożyczenie,GB2,2020,500000,500000
419325,Lewis Gibson,Fleetwood Town,0,Wypożyczenie,GB3,2019,500000,500000
663225,Tyler Onyango,Forest Green Rovers,450000,Wypożyczenie,GB3,2022,450000,0
663225,Tyler Onyango,Burton Albion,200000,Wypożyczenie,GB3,2022,450000,250000
421443,Charlie Kirk,Burton Albion,400000,Wypożyczenie,GB3,2022,400000,0
421443,Charlie Kirk,FC Blackpool,500000,Wypożyczenie,GB2,2021,400000,-100000
154287,Todd Kane,Charlton Athletic,400000,Wypożyczenie,GB3,2022,250000,-150000
154287,Todd Kane,Hull City,1000000,Wypożyczenie,GB2,2018,250000,-750000
314378,Admiral Muskwe,Fleetwood Town,400000,Wypożyczenie,GB3,2022,300000,-100000
314378,Admiral Muskwe,Wycombe Wanderers,100000,Wypożyczenie,GB2,2020,300000,200000
314378,Admiral Muskwe,Swindon Town,100000,Wypożyczenie,GB4,2019,300000,200000
433186,Bali Mumba,Plymouth Argyle,400000,Wypożyczenie,GB3,2022,900000,500000
433186,Bali Mumba,Peterborough United,500000,Wypożyczenie,GB2,2021,900000,400000
184684,Anthony Stewart,Milton Keynes Dons,400000,Wypożyczenie,GB3,2022,400000,0
586023,Max Watters,FC Barnsley,400000,Wypożyczenie,GB3,2022,300000,-100000
586023,Max Watters,Milton Keynes Dons,150000,Wypożyczenie,GB3,2021,300000,150000
535479,Jay Matete,Plymouth Argyle,400000,Wypożyczenie,GB3,2022,500000,100000
535479,Jay Matete,Grimsby Town,0,Wypożyczenie,GB4,2020,500000,500000
385412,Jordan Amissah,Burton Albion,400000,Wypożyczenie,GB3,2022,300000,-100000
485252,Owen Dale,FC Portsmouth,400000,Wypożyczenie,GB3,2022,500000,100000
485252,Owen Dale,FC Blackpool,0,Wypożyczenie,GB2,2021,500000,500000
551001,Owen Beck,Bolton Wanderers,400000,Wypożyczenie,GB3,2022,400000,0
564049,Steve Seddon,Cambridge United,350000,Wypożyczenie,GB3,2022,250000,-100000
564049,Steve Seddon,AFC Wimbledon,150000,Wypożyczenie,GB3,2020,250000,100000
564049,Steve Seddon,FC Portsmouth,150000,Wypożyczenie,GB3,2019,250000,100000
564049,Steve Seddon,AFC Wimbledon,0,Wypożyczenie,GB3,2018,250000,250000
564049,Steve Seddon,FC Stevenage,0,Wypożyczenie,GB4,2018,250000,250000
624267,Dale Taylor,Burton Albion,350000,Wypożyczenie,GB3,2022,500000,150000
289196,Julien Da Costa,Shrewsbury Town,300000,Wypożyczenie,GB3,2022,300000,0
566043,Nigel Lonwijk,Plymouth Argyle,300000,Wypożyczenie,GB3,2022,1000000,700000
337640,Glen Rea,Cheltenham Town,300000,Wypożyczenie,GB3,2022,250000,-50000
337640,Glen Rea,Wigan Athletic,600000,Wypożyczenie,GB3,2021,250000,-350000
396859,Jamie Cumming,Milton Keynes Dons,300000,Wypożyczenie,GB3,2022,1000000,700000
396859,Jamie Cumming,FC Gillingham,300000,Wypożyczenie,GB3,2021,1000000,700000
396859,Jamie Cumming,Milton Keynes Dons,300000,Wypożyczenie,GB3,2021,1000000,700000
396859,Jamie Cumming,FC Stevenage,450000,Wypożyczenie,GB4,2020,1000000,550000
614064,Jasper Moon,Burton Albion,300000,Wypożyczenie,GB3,2022,300000,0
456292,Ellery Balcombe,Bristol Rovers,300000,Wypożyczenie,GB3,2022,300000,0
456292,Ellery Balcombe,Crawley Town,300000,Wypożyczenie,GB4,2022,300000,0
456292,Ellery Balcombe,Burton Albion,300000,Wypożyczenie,GB3,2021,300000,0
456292,Ellery Balcombe,Doncaster Rovers,300000,Wypożyczenie,GB3,2020,300000,0
404381,Brandon Cooper,Forest Green Rovers,300000,Wypożyczenie,GB3,2022,300000,0
404381,Brandon Cooper,Swindon Town,500000,Wypożyczenie,GB4,2021,300000,-200000
404381,Brandon Cooper,Newport County,0,Wypożyczenie,GB4,2020,300000,300000
647395,Kyle Joseph,Oxford United,300000,Wypożyczenie,GB3,2022,400000,100000
647395,Kyle Joseph,Cheltenham Town,100000,Wypożyczenie,GB3,2021,400000,300000
602978,Tyler Smith,Oxford United,300000,Wypożyczenie,GB3,2022,200000,-100000
602978,Tyler Smith,Swindon Town,0,Wypożyczenie,GB3,2020,200000,200000
602978,Tyler Smith,Bristol Rovers,0,Wypożyczenie,GB3,2019,200000,200000
602978,Tyler Smith,AFC Rochdale,0,Wypożyczenie,GB3,2019,200000,200000
602978,Tyler Smith,Doncaster Rovers,0,Wypożyczenie,GB3,2018,200000,200000
532078,Brandon Fleming,Oxford United,300000,Wypożyczenie,GB3,2022,400000,100000
532078,Brandon Fleming,Bolton Wanderers,150000,Wypożyczenie,GB3,2019,400000,250000
623560,Liam Shaw,FC Morecambe,300000,Wypożyczenie,GB3,2022,500000,200000
220491,Matt Macey,FC Portsmouth,300000,Wypożyczenie,GB3,2022,400000,100000
220491,Matt Macey,Plymouth Argyle,500000,Wypożyczenie,GB3,2018,400000,-100000
627248,Lewis Dobbin,Derby County,300000,Wypożyczenie,GB3,2022,900000,600000
655880,Mipo Odubeko,Port Vale FC,300000,Wypożyczenie,GB3,2022,350000,50000
655880,Mipo Odubeko,Huddersfield Town,250000,Wypożyczenie,GB2,2021,350000,100000
655880,Mipo Odubeko,Doncaster Rovers,300000,Wypożyczenie,GB3,2021,350000,50000
645686,Lamare Bogarde,Bristol Rovers,300000,Wypożyczenie,GB3,2022,450000,150000
496661,Elliot Thorpe,Burton Albion,300000,Wypożyczenie,GB3,2022,250000,-50000
203127,Conor McGrandles,Cambridge United,300000,Wypożyczenie,GB3,2022,400000,100000
758030,Elkan Baggott,Cheltenham Town,250000,Wypożyczenie,GB3,2022,250000,0
758030,Elkan Baggott,FC Gillingham,0,Wypożyczenie,GB4,2022,250000,250000
285846,Sam Lavelle,Burton Albion,250000,Wypożyczenie,GB3,2022,250000,0
671074,Caleb Taylor,Cheltenham Town,250000,Wypożyczenie,GB3,2022,900000,650000
699164,Jahmari Clarke,Forest Green Rovers,250000,Wypożyczenie,GB3,2022,250000,0
401268,Olamide Shodipo,Lincoln City,250000,Wypożyczenie,GB3,2022,300000,50000
401268,Olamide Shodipo,Sheffield Wednesday,200000,Wypożyczenie,GB3,2021,300000,100000
401268,Olamide Shodipo,Oxford United,100000,Wypożyczenie,GB3,2020,300000,200000
485546,Matt Penney,Charlton Athletic,250000,Wypożyczenie,GB3,2022,250000,0
610665,Caleb Watts,FC Morecambe,250000,Wypożyczenie,GB3,2022,250000,0
610665,Caleb Watts,Crawley Town,250000,Wypożyczenie,GB4,2021,250000,0
588412,Carlos Mendes,Fleetwood Town,250000,Wypożyczenie,GB3,2022,300000,50000
670883,Dane Scarlett,FC Portsmouth,250000,Wypożyczenie,GB3,2022,1000000,750000
502074,Sylvester Jasper,Bristol Rovers,250000,Wypożyczenie,GB3,2022,250000,0
502074,Sylvester Jasper,Colchester United,250000,Wypożyczenie,GB4,2021,250000,0
559800,Oliver Casey,Forest Green Rovers,250000,Wypożyczenie,GB3,2022,300000,50000
284718,Harry Isted,FC Barnsley,250000,Wypożyczenie,GB3,2022,400000,150000
581113,Bryan Fiabema,Forest Green Rovers,200000,Wypożyczenie,GB3,2022,200000,0
633168,Gassan Ahadme,Burton Albion,200000,Wypożyczenie,GB3,2022,200000,0
633168,Gassan Ahadme,FC Portsmouth,50000,Wypożyczenie,GB3,2021,200000,150000
470596,Paris Maghoma,Milton Keynes Dons,200000,Wypożyczenie,GB3,2022,350000,150000
470596,Paris Maghoma,AFC Wimbledon,200000,Wypożyczenie,GB4,2022,350000,150000
610850,Kieran Phillips,FC Morecambe,200000,Wypożyczenie,GB3,2022,300000,100000
610850,Kieran Phillips,FC Walsall,200000,Wypożyczenie,GB4,2021,300000,100000
610850,Kieran Phillips,Exeter City,200000,Wypożyczenie,GB4,2021,300000,100000
486144,Jakub Stolarczyk,Fleetwood Town,200000,Wypożyczenie,GB3,2022,250000,50000
486144,Jakub Stolarczyk,Hartlepool United,200000,Wypożyczenie,GB4,2022,250000,50000
285033,Will Norris,Peterborough United,200000,Wypożyczenie,GB3,2022,350000,150000
285033,Will Norris,Ipswich Town,250000,Wypożyczenie,GB3,2019,350000,100000
712592,Harvey Cartwright,Wycombe Wanderers,200000,Wypożyczenie,GB3,2022,200000,0
712592,Harvey Cartwright,Peterborough United,200000,Wypożyczenie,GB3,2022,200000,0
337101,Jack Stevens,Port Vale FC,200000,Wypożyczenie,GB3,2022,200000,0
624243,Aaron Donnelly,Port Vale FC,200000,Wypożyczenie,GB3,2022,400000,200000
183301,Luke McGee,Derby County,200000,Wypożyczenie,GB3,2022,200000,0
183301,Luke McGee,Bradford City,100000,Wypożyczenie,GB4,2019,200000,100000
279458,Matty Virtue,Lincoln City,200000,Wypożyczenie,GB3,2022,250000,50000
478637,Daniel Butterworth,Port Vale FC,200000,Wypożyczenie,GB3,2022,200000,0
478637,Daniel Butterworth,Fleetwood Town,200000,Wypożyczenie,GB3,2021,200000,0
539807,Christian Marques,Forest Green Rovers,200000,Wypożyczenie,GB3,2022,200000,0
470152,Dennis Politic,Port Vale FC,200000,Wypożyczenie,GB3,2022,200000,0
470152,Dennis Politic,Port Vale FC,0,Wypożyczenie,GB4,2021,200000,200000
484838,Viljami Sinisalo,Burton Albion,200000,Wypożyczenie,GB3,2022,400000,200000
788283,Bobby Thomas,Bristol Rovers,150000,Wypożyczenie,GB3,2022,450000,300000
788283,Bobby Thomas,FC Barnsley,150000,Wypożyczenie,GB3,2022,450000,300000
788283,Bobby Thomas,AFC Barrow,200000,Wypożyczenie,GB4,2020,450000,250000
592980,Ateef Konaté,Oxford United,150000,Wypożyczenie,GB3,2022,150000,0
520651,Jensen Weir,FC Morecambe,150000,Wypożyczenie,GB3,2022,450000,300000
520651,Jensen Weir,Cambridge United,150000,Wypożyczenie,GB3,2021,450000,300000
703577,Kgaogelo Chauke,Exeter City,150000,Wypożyczenie,GB3,2022,250000,100000
532195,Joshua Kayode,Milton Keynes Dons,150000,Wypożyczenie,GB3,2022,150000,0
532195,Joshua Kayode,Carlisle United,50000,Wypożyczenie,GB4,2020,150000,100000
532195,Joshua Kayode,Carlisle United,50000,Wypożyczenie,GB4,2019,150000,100000
746554,Thierry Small,Port Vale FC,100000,Wypożyczenie,GB3,2022,1000000,900000
484385,Jack Diamond,Lincoln City,100000,Wypożyczenie,GB3,2022,100000,0
484385,Jack Diamond,Harrogate Town,0,Wypożyczenie,GB4,2021,100000,100000
251831,Joe Pigott,FC Portsmouth,100000,Wypożyczenie,GB3,2022,450000,350000
471003,Aaron Pressley,Accrington Stanley,100000,Wypożyczenie,GB3,2022,200000,100000
471003,Aaron Pressley,AFC Wimbledon,100000,Wypożyczenie,GB3,2021,200000,100000
433329,Corrie Ndaba,Fleetwood Town,100000,Wypożyczenie,GB3,2022,200000,100000
433329,Corrie Ndaba,Burton Albion,100000,Wypożyczenie,GB3,2022,200000,100000
433329,Corrie Ndaba,Salford City,50000,Wypożyczenie,GB4,2021,200000,150000
576099,Joseph Anang,Derby County,100000,Wypożyczenie,GB3,2022,100000,0
576099,Joseph Anang,FC Stevenage,0,Wypożyczenie,GB4,2021,100000,100000
728983,Josh Austerfield,FC Morecambe,100000,Wypożyczenie,GB3,2022,100000,0
728983,Josh Austerfield,Harrogate Town,100000,Wypożyczenie,GB4,2021,100000,0
566733,Jökull Andrésson,Exeter City,100000,Wypożyczenie,GB3,2022,150000,50000
566733,Jökull Andrésson,FC Stevenage,100000,Wypożyczenie,GB4,2022,150000,50000
566733,Jökull Andrésson,FC Morecambe,100000,Wypożyczenie,GB3,2021,150000,50000
566733,Jökull Andrésson,Exeter City,100000,Wypożyczenie,GB4,2020,150000,50000
566733,Jökull Andrésson,FC Morecambe,100000,Wypożyczenie,GB4,2020,150000,50000
746778,Harry Boyes,Lincoln City,100000,Wypożyczenie,GB3,2022,250000,150000
746778,Harry Boyes,Forest Green Rovers,0,Wypożyczenie,GB3,2022,250000,250000
801420,Killian Phillips,Shrewsbury Town,75000,Wypożyczenie,GB3,2022,150000,75000
452019,Harry Smith,Exeter City,50000,Wypożyczenie,GB3,2022,50000,0
655835,Christian Saydee,Shrewsbury Town,50000,Wypożyczenie,GB3,2022,250000,200000
655835,Christian Saydee,Burton Albion,50000,Wypożyczenie,GB3,2021,250000,200000
581890,Lukas Jensen,Accrington Stanley,50000,Wypożyczenie,GB3,2022,250000,200000
581890,Lukas Jensen,Carlisle United,25000,Wypożyczenie,GB4,2021,250000,225000
581890,Lukas Jensen,Bolton Wanderers,25000,Wypożyczenie,GB4,2020,250000,225000
537864,Doug Tharme,Accrington Stanley,50000,Wypożyczenie,GB3,2022,150000,100000
346237,Kabongo Tshimanga,Peterborough United,0,Wypożyczenie,GB3,2022,150000,150000
586984,Daniel Oyegoke,Milton Keynes Dons,0,Wypożyczenie,GB3,2022,500000,500000
703474,Robert Street,Shrewsbury Town,0,Wypożyczenie,GB3,2022,200000,200000
703474,Robert Street,Newport County,0,Wypożyczenie,GB4,2021,200000,200000
511552,Ryan Astley,Accrington Stanley,0,Wypożyczenie,GB3,2022,600000,600000
614811,Joe White,Exeter City,0,Wypożyczenie,GB3,2022,250000,250000
614811,Joe White,Hartlepool United,0,Wypożyczenie,GB4,2021,250000,250000
490606,Lucas Bergström,Peterborough United,0,Wypożyczenie,GB3,2022,250000,250000
646353,Carl Rushworth,Lincoln City,0,Wypożyczenie,GB3,2022,900000,900000
646353,Carl Rushworth,FC Walsall,0,Wypożyczenie,GB4,2021,900000,900000
872546,Quévin Castro,Burton Albion,0,Wypożyczenie,GB3,2022,0,0
652979,Lewis Warrington,Fleetwood Town,0,Wypożyczenie,GB3,2022,500000,500000
652979,Lewis Warrington,Tranmere Rovers,0,Wypożyczenie,GB4,2021,500000,500000
502073,Taylor Perry,Cheltenham Town,0,Wypożyczenie,GB3,2022,350000,350000
502073,Taylor Perry,Cheltenham Town,0,Wypożyczenie,GB3,2021,350000,350000
570864,Tony Springett,Derby County,0,Wypożyczenie,GB3,2022,350000,350000
480723,Finn Azaz,Plymouth Argyle,0,Wypożyczenie,GB3,2022,700000,700000
480723,Finn Azaz,Newport County,0,Wypożyczenie,GB4,2021,700000,700000
480723,Finn Azaz,Cheltenham Town,0,Wypożyczenie,GB4,2020,700000,700000
801424,James Taylor,Cheltenham Town,0,Wypożyczenie,GB3,2022,50000,50000
484389,Kell Watts,Peterborough United,0,Wypożyczenie,GB3,2022,200000,200000
484389,Kell Watts,Wigan Athletic,0,Wypożyczenie,GB3,2021,200000,200000
484389,Kell Watts,Plymouth Argyle,0,Wypożyczenie,GB3,2020,200000,200000
484389,Kell Watts,FC Stevenage,0,Wypożyczenie,GB4,2019,200000,200000
484389,Kell Watts,Mansfield Town,0,Wypożyczenie,GB4,2019,200000,200000
609556,William Osula,Derby County,0,Wypożyczenie,GB3,2022,150000,150000
632349,Jarell Quansah,Bristol Rovers,0,Wypożyczenie,GB3,2022,400000,400000
638964,Nathan Butler-Oyedeji,Accrington Stanley,0,Wypożyczenie,GB3,2022,100000,100000
699018,Zac Ashworth,Burton Albion,0,Wypożyczenie,GB3,2022,250000,250000
618402,Ziyad Larkeche,FC Barnsley,0,Wypożyczenie,GB3,2022,350000,350000
714459,Michael Mellon,FC Morecambe,0,Wypożyczenie,GB3,2022,150000,150000
484387,Matty Longstaff,Colchester United,1000000,Wypożyczenie,GB4,2022,1000000,0
484387,Matty Longstaff,Mansfield Town,2000000,Wypożyczenie,GB4,2021,1000000,-1000000
503769,Arthur Okonkwo,Crewe Alexandra,1000000,Wypożyczenie,GB4,2022,1000000,0
433991,Ethan Galbraith,Salford City,800000,Wypożyczenie,GB4,2022,600000,-200000
433991,Ethan Galbraith,Doncaster Rovers,900000,Wypożyczenie,GB3,2021,600000,-300000
565913,Luke Jephcott,Swindon Town,700000,Wypożyczenie,GB4,2022,450000,-250000
148908,Aiden O'Brien,FC Gillingham,600000,Wypożyczenie,GB4,2022,450000,-150000
655877,Thimothée Lo-Tutala,FC Stevenage,600000,Wypożyczenie,GB4,2022,600000,0
347481,Adam Lewis,Newport County,500000,Wypożyczenie,GB4,2022,300000,-200000
347481,Adam Lewis,Plymouth Argyle,500000,Wypożyczenie,GB3,2020,300000,-200000
495441,Ryan Schofield,Crawley Town,500000,Wypożyczenie,GB4,2022,400000,-100000
495441,Ryan Schofield,Notts County,100000,Wypożyczenie,GB4,2018,400000,300000
538871,Toby Savin,FC Stevenage,450000,Wypożyczenie,GB4,2022,300000,-150000
178139,Daryl Horgan,FC Stevenage,450000,Wypożyczenie,GB4,2022,200000,-250000
531678,D'Mani Mellor,AFC Rochdale,450000,Wypożyczenie,GB4,2022,300000,-150000
531678,D'Mani Mellor,Salford City,0,Wypożyczenie,GB4,2021,300000,300000
463755,Dean Campbell,FC Stevenage,425000,Wypożyczenie,GB4,2022,350000,-75000
470604,Paul Glatzel,Tranmere Rovers,400000,Wypożyczenie,GB4,2022,250000,-150000
470604,Paul Glatzel,Tranmere Rovers,350000,Wypożyczenie,GB4,2021,250000,-100000
415816,Diallang Jaiyesimi,AFC Wimbledon,400000,Wypożyczenie,GB4,2022,250000,-150000
415816,Diallang Jaiyesimi,Swindon Town,0,Wypożyczenie,GB4,2019,250000,250000
415816,Diallang Jaiyesimi,Yeovil Town,0,Wypożyczenie,GB4,2018,250000,250000
849429,Tete Yengi,Northampton Town,400000,Wypożyczenie,GB4,2022,300000,-100000
290801,Jamie McCart,Leyton Orient,400000,Wypożyczenie,GB4,2022,350000,-50000
502062,D'Margio Wright-Phillips,Northampton Town,400000,Wypożyczenie,GB4,2022,400000,0
238440,Alex Gilbey,FC Stevenage,400000,Wypożyczenie,GB4,2022,350000,-50000
396548,Logan Chalmers,Tranmere Rovers,375000,Wypożyczenie,GB4,2022,300000,-75000
339023,Mathew Stevens,FC Walsall,350000,Wypożyczenie,GB4,2022,250000,-100000
339023,Mathew Stevens,FC Stevenage,0,Wypożyczenie,GB4,2020,250000,250000
455917,Josh Eppiah,Northampton Town,350000,Wypożyczenie,GB4,2022,250000,-100000
455917,Josh Eppiah,Northampton Town,350000,Wypożyczenie,GB4,2021,250000,-100000
530915,Teddy Jenks,Crawley Town,325000,Wypożyczenie,GB4,2022,300000,-25000
518021,Jack Hamilton,Hartlepool United,325000,Wypożyczenie,GB4,2022,300000,-25000
463751,Marc Leonard,Northampton Town,300000,Wypożyczenie,GB4,2022,300000,0
260368,Christy Pym,Mansfield Town,300000,Wypożyczenie,GB4,2022,300000,0
260368,Christy Pym,FC Stevenage,300000,Wypożyczenie,GB4,2021,300000,0
614700,Dara Costelloe,Bradford City,300000,Wypożyczenie,GB4,2022,300000,0
529747,Clarke Oduor,Hartlepool United,300000,Wypożyczenie,GB4,2022,300000,0
696326,Max Woltman,Doncaster Rovers,300000,Wypożyczenie,GB4,2022,300000,0
344525,Danny Johnson,FC Walsall,300000,Wypożyczenie,GB4,2022,150000,-150000
293784,Conor Masterson,FC Gillingham,300000,Wypożyczenie,GB4,2022,250000,-50000
293784,Conor Masterson,FC Gillingham,300000,Wypożyczenie,GB3,2021,250000,-50000
293784,Conor Masterson,Cambridge United,300000,Wypożyczenie,GB3,2021,250000,-50000
293784,Conor Masterson,Swindon Town,300000,Wypożyczenie,GB3,2020,250000,-50000
689891,Romoney Crichlow,Bradford City,300000,Wypożyczenie,GB4,2022,150000,-150000
689891,Romoney Crichlow,Plymouth Argyle,300000,Wypożyczenie,GB3,2021,150000,-150000
689891,Romoney Crichlow,Swindon Town,300000,Wypożyczenie,GB4,2021,150000,-150000
497143,Ashley Maynard-Brewer,FC Gillingham,300000,Wypożyczenie,GB4,2022,400000,100000
285287,Regan Hendry,Tranmere Rovers,300000,Wypożyczenie,GB4,2022,250000,-50000
222740,Kieran Sadlier,Leyton Orient,300000,Wypożyczenie,GB4,2022,250000,-50000
530782,Jack Stretton,Carlisle United,300000,Wypożyczenie,GB4,2022,250000,-50000
396857,Dan Kemp,Hartlepool United,300000,Wypożyczenie,GB4,2022,300000,0
396857,Dan Kemp,FC Blackpool,0,Wypożyczenie,GB3,2020,300000,300000
396857,Dan Kemp,FC Stevenage,0,Wypożyczenie,GB4,2019,300000,300000
621193,Kasey McAteer,AFC Wimbledon,300000,Wypożyczenie,GB4,2022,250000,-50000
621193,Kasey McAteer,Forest Green Rovers,300000,Wypożyczenie,GB4,2021,250000,-50000
566349,Matty Daly,Harrogate Town,250000,Wypożyczenie,GB4,2022,200000,-50000
566349,Matty Daly,Hartlepool United,250000,Wypożyczenie,GB4,2021,200000,-50000
566349,Matty Daly,Bradford City,250000,Wypożyczenie,GB4,2021,200000,-50000
532464,Daniel Adshead,AFC Rochdale,250000,Wypożyczenie,GB4,2022,125000,-125000
532464,Daniel Adshead,FC Gillingham,200000,Wypożyczenie,GB3,2021,125000,-75000
607199,Saikou Janneh,AFC Wimbledon,250000,Wypożyczenie,GB4,2022,200000,-50000
607199,Saikou Janneh,Shrewsbury Town,0,Wypożyczenie,GB3,2021,200000,200000
607199,Saikou Janneh,Newport County,0,Wypożyczenie,GB4,2020,200000,200000
255129,Hakeeb Adelakun,FC Gillingham,250000,Wypożyczenie,GB4,2022,175000,-75000
255129,Hakeeb Adelakun,Hull City,400000,Wypożyczenie,GB3,2020,175000,-225000
255129,Hakeeb Adelakun,Rotherham United,500000,Wypożyczenie,GB3,2019,175000,-325000
499604,Dion Pereira,Bradford City,250000,Wypożyczenie,GB4,2022,200000,-50000
499604,Dion Pereira,Bradford City,300000,Wypożyczenie,GB4,2021,200000,-100000
561452,Dan Chesters,Colchester United,250000,Wypożyczenie,GB4,2022,250000,0
530736,Keyendrah Simmonds,Grimsby Town,250000,Wypożyczenie,GB4,2022,250000,0
554365,Josh Reid,FC Stevenage,250000,Wypożyczenie,GB4,2022,250000,0
596821,Scott Banks,Bradford City,250000,Wypożyczenie,GB4,2022,300000,50000
485994,David Ajiboye,Sutton United,250000,Wypożyczenie,GB4,2022,250000,0
564048,Charlie Lakin,Doncaster Rovers,250000,Wypożyczenie,GB4,2022,175000,-75000
564048,Charlie Lakin,FC Stevenage,100000,Wypożyczenie,GB4,2019,175000,75000
565406,Kazeem Olaigbe,Harrogate Town,225000,Wypożyczenie,GB4,2022,400000,175000
194386,Alex Cairns,Hartlepool United,200000,Wypożyczenie,GB4,2022,200000,0
194386,Alex Cairns,Salford City,200000,Wypożyczenie,GB4,2022,200000,0
580809,Ed Turns,Leyton Orient,200000,Wypożyczenie,GB4,2022,350000,150000
614262,Charlie McNeill,Newport County,200000,Wypożyczenie,GB4,2022,200000,0
742746,Caleb Chukwuemeka,Crawley Town,200000,Wypożyczenie,GB4,2022,200000,0
657863,Lewis Richardson,Grimsby Town,200000,Wypożyczenie,GB4,2022,200000,0
433184,Rayhaan Tulloch,AFC Rochdale,200000,Wypożyczenie,GB4,2022,200000,0
433184,Rayhaan Tulloch,Doncaster Rovers,0,Wypożyczenie,GB3,2020,200000,200000
647376,Luke Robinson,Tranmere Rovers,200000,Wypożyczenie,GB4,2022,150000,-50000
121223,Kwesi Appiah,Colchester United,200000,Wypożyczenie,GB4,2022,125000,-75000
633492,Charlie Kelman,Leyton Orient,200000,Wypożyczenie,GB4,2022,250000,50000
633492,Charlie Kelman,FC Gillingham,200000,Wypożyczenie,GB3,2021,250000,50000
657994,Aaron Rowe,Stockport County,200000,Wypożyczenie,GB4,2022,175000,-25000
387360,Joe Grayson,Stockport County,175000,Wypożyczenie,GB4,2022,150000,-25000
387360,Joe Grayson,Oxford United,0,Wypożyczenie,GB3,2020,150000,150000
387360,Joe Grayson,Grimsby Town,0,Wypożyczenie,GB4,2018,150000,150000
807318,Ryan Finnigan,Crewe Alexandra,150000,Wypożyczenie,GB4,2022,250000,100000
532192,George Lloyd,Grimsby Town,150000,Wypożyczenie,GB4,2022,150000,0
532192,George Lloyd,Port Vale FC,0,Wypożyczenie,GB4,2021,150000,150000
698097,Hayden Lindley,Newport County,150000,Wypożyczenie,GB4,2022,150000,0
506440,Joe Tomlinson,Swindon Town,150000,Wypożyczenie,GB4,2022,150000,0
506440,Joe Tomlinson,Swindon Town,100000,Wypożyczenie,GB4,2021,150000,50000
633399,Idris El Mizouni,Leyton Orient,150000,Wypożyczenie,GB4,2022,300000,150000
633399,Idris El Mizouni,Grimsby Town,0,Wypożyczenie,GB4,2020,300000,300000
633399,Idris El Mizouni,Cambridge United,0,Wypożyczenie,GB4,2020,300000,300000
633399,Idris El Mizouni,Cambridge United,0,Wypożyczenie,GB4,2019,300000,300000
734375,Jack Jenkins,Salford City,150000,Wypożyczenie,GB4,2022,150000,0
638649,Femi Seriki,AFC Rochdale,150000,Wypożyczenie,GB4,2022,175000,25000
507115,Lachlan Brook,Crewe Alexandra,150000,Wypożyczenie,GB4,2022,150000,0
577895,Bez Lubala,Colchester United,150000,Wypożyczenie,GB4,2022,150000,0
577895,Bez Lubala,Northampton Town,100000,Wypożyczenie,GB4,2021,150000,50000
550134,Ciaran Brennan,Swindon Town,150000,Wypożyczenie,GB4,2022,150000,0
530916,Jack Spong,Crawley Town,150000,Wypożyczenie,GB4,2022,150000,0
340307,Tolaji Bola,Bradford City,150000,Wypożyczenie,GB4,2022,150000,0
340307,Tolaji Bola,AFC Rochdale,0,Wypożyczenie,GB3,2020,150000,150000
551964,Matthew Dennis,Sutton United,150000,Wypożyczenie,GB4,2022,150000,0
123371,Tom Eastman,Harrogate Town,150000,Wypożyczenie,GB4,2022,125000,-25000
465952,Sol Brynn,Swindon Town,150000,Wypożyczenie,GB4,2022,175000,25000
696762,Jonathan Tomkinson,FC Stevenage,150000,Wypożyczenie,GB4,2022,150000,0
511964,Jackson Smith,FC Walsall,150000,Wypożyczenie,GB4,2022,150000,0
577557,Danny Grant,Harrogate Town,150000,Wypożyczenie,GB4,2022,150000,0
801422,Ryley Towler,AFC Wimbledon,100000,Wypożyczenie,GB4,2022,900000,800000
566888,Thomas Dickson-Peters,Grimsby Town,100000,Wypożyczenie,GB4,2022,200000,100000
566888,Thomas Dickson-Peters,FC Gillingham,100000,Wypożyczenie,GB3,2021,200000,100000
543093,Josh Neufville,Sutton United,100000,Wypożyczenie,GB4,2022,125000,25000
337279,Armani Little,AFC Wimbledon,100000,Wypożyczenie,GB4,2022,200000,100000
437573,James Brown,Doncaster Rovers,100000,Wypożyczenie,GB4,2022,125000,25000
437573,James Brown,Stockport County,100000,Wypożyczenie,GB4,2022,125000,25000
677939,Flynn Clarke,FC Walsall,100000,Wypożyczenie,GB4,2022,100000,0
403564,Jon McCracken,FC Stevenage,100000,Wypożyczenie,GB4,2022,175000,75000
675993,Frazer Blake-Tracy,Swindon Town,100000,Wypożyczenie,GB4,2022,175000,75000
607522,Josh Coley,Harrogate Town,100000,Wypożyczenie,GB4,2022,100000,0
163523,Matty Dolan,Hartlepool United,100000,Wypożyczenie,GB4,2022,175000,75000
526873,Jake Eastwood,AFC Rochdale,100000,Wypożyczenie,GB4,2022,125000,25000
526873,Jake Eastwood,FC Portsmouth,100000,Wypożyczenie,GB3,2021,125000,25000
526873,Jake Eastwood,Grimsby Town,100000,Wypożyczenie,GB4,2020,125000,25000
526873,Jake Eastwood,Scunthorpe United,100000,Wypożyczenie,GB4,2019,125000,25000
461882,Khanya Leshabela,Crewe Alexandra,100000,Wypożyczenie,GB4,2022,100000,0
461882,Khanya Leshabela,Shrewsbury Town,100000,Wypożyczenie,GB3,2021,100000,0
625082,Haji Mnoga,FC Gillingham,100000,Wypożyczenie,GB4,2022,100000,0
243623,Stuart Moore,Doncaster Rovers,100000,Wypożyczenie,GB4,2022,100000,0
374263,Charlie Owens,Colchester United,100000,Wypożyczenie,GB4,2022,100000,0
374263,Charlie Owens,Wycombe Wanderers,0,Wypożyczenie,GB3,2018,100000,100000
144341,Yann Songo'o,FC Walsall,100000,Wypożyczenie,GB4,2022,125000,25000
683856,Tyla Dickinson,Sutton United,100000,Wypożyczenie,GB4,2022,100000,0
486604,Vitezslav Jaros,Stockport County,100000,Wypożyczenie,GB4,2022,150000,50000
696502,Aribim Pepple,Grimsby Town,75000,Wypożyczenie,GB4,2022,100000,25000
741591,Jacob Chapman,Salford City,75000,Wypożyczenie,GB4,2022,75000,0
48261,Glenn Morris,FC Gillingham,50000,Wypożyczenie,GB4,2022,100000,50000
568063,Chanka Zimba,Newport County,50000,Wypożyczenie,GB4,2022,100000,50000
568063,Chanka Zimba,Northampton Town,50000,Wypożyczenie,GB4,2021,100000,50000
503731,Stephen Duke-McKenna,Leyton Orient,50000,Wypożyczenie,GB4,2022,75000,25000
837207,Charley Kendall,Sutton United,50000,Wypożyczenie,GB4,2022,50000,0
721485,Kian Harratt,Bradford City,50000,Wypożyczenie,GB4,2022,50000,0
721485,Kian Harratt,Port Vale FC,50000,Wypożyczenie,GB4,2021,50000,0
721485,Kian Harratt,Harrogate Town,0,Wypożyczenie,GB4,2020,50000,50000
66501,Robbie Willmott,FC Walsall,50000,Wypożyczenie,GB4,2022,100000,50000
66501,Robbie Willmott,Exeter City,50000,Wypożyczenie,GB4,2020,100000,50000
502071,Sonny Hilton,Carlisle United,25000,Wypożyczenie,GB4,2022,25000,0
231602,Scott Quigley,AFC Rochdale,0,Wypożyczenie,GB4,2022,125000,125000
231602,Scott Quigley,Port Vale FC,0,Wypożyczenie,GB4,2018,125000,125000
492391,Tristan Abrahams,FC Gillingham,0,Wypożyczenie,GB4,2022,175000,175000
492391,Tristan Abrahams,Leyton Orient,150000,Wypożyczenie,GB4,2020,175000,25000
492391,Tristan Abrahams,Exeter City,0,Wypożyczenie,GB4,2018,175000,175000
492391,Tristan Abrahams,Yeovil Town,0,Wypożyczenie,GB4,2018,175000,175000
374062,Matty Foulds,Harrogate Town,0,Wypożyczenie,GB4,2022,175000,175000
644241,Sam Pearson,AFC Wimbledon,0,Wypożyczenie,GB4,2022,200000,200000
714458,Ben Nelson,Doncaster Rovers,0,Wypożyczenie,GB4,2022,100000,100000
714458,Ben Nelson,AFC Rochdale,0,Wypożyczenie,GB4,2022,100000,100000
632135,Duncan Idehen,Carlisle United,0,Wypożyczenie,GB4,2022,0,0
540690,Tom Smith,Colchester United,0,Wypożyczenie,GB4,2022,75000,75000
735140,Jayden Wareham,Leyton Orient,0,Wypożyczenie,GB4,2022,0,0
633464,Joe Low,FC Walsall,0,Wypożyczenie,GB4,2022,125000,125000
621997,Cieran Slicker,AFC Rochdale,0,Wypożyczenie,GB4,2022,0,0
314354,Taye Ashby-Hammond,FC Stevenage,0,Wypożyczenie,GB4,2022,150000,150000
551004,David Robson,Crawley Town,0,Wypożyczenie,GB4,2022,0,0
433165,Danny Cashman,FC Walsall,0,Wypożyczenie,GB4,2022,0,0
433165,Danny Cashman,AFC Rochdale,0,Wypożyczenie,GB4,2021,0,0
565674,Riley Harbottle,Mansfield Town,0,Wypożyczenie,GB4,2022,200000,200000
794437,Jake Young,AFC Barrow,0,Wypożyczenie,GB4,2022,150000,150000
583991,Matthew Baker,Newport County,0,Wypożyczenie,GB4,2022,250000,250000
731752,Giosue Bellagambi,Salford City,0,Wypożyczenie,GB4,2022,75000,75000
573054,Josh Andrews,Doncaster Rovers,0,Wypożyczenie,GB4,2022,0,0
573054,Josh Andrews,AFC Rochdale,0,Wypożyczenie,GB4,2021,0,0
573054,Josh Andrews,Harrogate Town,0,Wypożyczenie,GB4,2020,0,0
655139,Nathan Moriah-Welsh,Newport County,0,Wypożyczenie,GB4,2022,150000,150000
686839,Owen Dodgson,AFC Rochdale,0,Wypożyczenie,GB4,2022,300000,300000
250750,Rollin Menayese,Hartlepool United,0,Wypożyczenie,GB4,2022,125000,125000
250750,Rollin Menayese,FC Walsall,0,Wypożyczenie,GB4,2021,125000,125000
250750,Rollin Menayese,Grimsby Town,0,Wypożyczenie,GB4,2020,125000,125000
504855,John McAtee,Grimsby Town,0,Wypożyczenie,GB4,2022,175000,175000
533474,Jack Robinson,Carlisle United,0,Wypożyczenie,GB4,2022,125000,125000
661052,Todd Miller,Doncaster Rovers,0,Wypożyczenie,GB4,2022,200000,200000
581679,Nathan Young-Coombes,AFC Wimbledon,0,Wypożyczenie,GB4,2022,0,0
670860,James Beadle,Crewe Alexandra,0,Wypożyczenie,GB4,2022,2000000,2000000
670819,Joe O'Shaughnessy,Bradford City,0,Wypożyczenie,GB4,2022,0,0
911757,Liam Bennett,FC Walsall,0,Wypożyczenie,GB4,2022,300000,300000
808308,Sean Robertson,Crewe Alexandra,0,Wypożyczenie,GB4,2022,100000,100000
581445,Mazeed Ogungbo,Crawley Town,0,Wypożyczenie,GB4,2022,150000,150000
507498,Lorent Tolaj,Salford City,0,Wypożyczenie,GB4,2022,0,0
507498,Lorent Tolaj,Cambridge United,0,Wypożyczenie,GB3,2021,0,0
655987,James Balagizi,Crawley Town,0,Wypożyczenie,GB4,2022,0,0
646208,Will Swan,Mansfield Town,0,Wypożyczenie,GB4,2022,250000,250000
646208,Will Swan,Port Vale FC,0,Wypożyczenie,GB4,2020,250000,250000
698196,Calum Kavanagh,Newport County,0,Wypożyczenie,GB4,2022,100000,100000
698196,Calum Kavanagh,Harrogate Town,0,Wypożyczenie,GB4,2021,100000,100000
646210,Fin Back,Carlisle United,0,Wypożyczenie,GB4,2022,300000,300000
192075,Brendan Kiernan,Grimsby Town,0,Wypożyczenie,GB4,2022,150000,150000
565915,Ryan Law,FC Gillingham,0,Wypożyczenie,GB4,2022,0,0
659331,John-Kymani Gordon,Carlisle United,0,Wypożyczenie,GB4,2022,100000,100000
743741,Andy Smith,Grimsby Town,0,Wypożyczenie,GB4,2022,175000,175000
743741,Andy Smith,Salford City,0,Wypożyczenie,GB4,2021,175000,175000
731755,Jaheim Headley,Harrogate Town,0,Wypożyczenie,GB4,2022,0,0
335593,Ben Barclay,Carlisle United,0,Wypożyczenie,GB4,2022,100000,100000
335593,Ben Barclay,Notts County,0,Wypożyczenie,GB4,2018,100000,100000
670989,Saxon Earley,FC Stevenage,0,Wypożyczenie,GB4,2022,200000,200000
530952,Thierry Nevers,Bradford City,0,Wypożyczenie,GB4,2022,200000,200000
530952,Thierry Nevers,Newport County,0,Wypożyczenie,GB4,2022,200000,200000
549566,Sam McClelland,AFC Barrow,0,Wypożyczenie,GB4,2022,150000,150000
814340,Douglas James-Taylor,FC Walsall,0,Wypożyczenie,GB4,2022,200000,200000
505657,Tyreik Wright,Bradford City,0,Wypożyczenie,GB4,2022,200000,200000
505657,Tyreik Wright,Colchester United,0,Wypożyczenie,GB4,2021,200000,200000
505657,Tyreik Wright,Salford City,0,Wypożyczenie,GB4,2021,200000,200000
505657,Tyreik Wright,FC Walsall,0,Wypożyczenie,GB4,2020,200000,200000
626319,Tom Fellows,Crawley Town,0,Wypożyczenie,GB4,2022,400000,400000
647280,Kieron Bowie,Northampton Town,0,Wypożyczenie,GB4,2022,250000,250000
571827,Lewis Richards,Harrogate Town,0,Wypożyczenie,GB4,2022,175000,175000
571827,Lewis Richards,Harrogate Town,0,Wypożyczenie,GB4,2021,175000,175000
726860,Jay Turner-Cooke,Tranmere Rovers,0,Wypożyczenie,GB4,2022,200000,200000
746736,Harrison Neal,AFC Barrow,0,Wypożyczenie,GB4,2022,250000,250000
854935,Mikey O'Neill,Grimsby Town,0,Wypożyczenie,GB4,2022,100000,100000
969415,Tayt-Lemar Trusty,Hartlepool United,0,Wypożyczenie,GB4,2022,100000,100000
657815,Taylor Foran,Hartlepool United,0,Wypożyczenie,GB4,2022,175000,175000
551007,Eli King,Crewe Alexandra,0,Wypożyczenie,GB4,2022,0,0
766253,Dylan Kadji,Swindon Town,0,Wypożyczenie,GB4,2022,100000,100000
454135,Connor Wood,Colchester United,0,Wypożyczenie,GB4,2022,150000,150000
632350,Ellis Taylor,Hartlepool United,0,Wypożyczenie,GB4,2022,0,0
829766,Kyle Hudlin,AFC Wimbledon,0,Wypożyczenie,GB4,2022,0,0
471368,Alfie McCalmont,Carlisle United,0,Wypożyczenie,GB4,2022,150000,150000
471368,Alfie McCalmont,FC Morecambe,0,Wypożyczenie,GB3,2021,150000,150000
471368,Alfie McCalmont,Oldham Athletic,0,Wypożyczenie,GB4,2020,150000,150000
332341,Todd Cantwell,AFC Bournemouth,20000000,Wypożyczenie,GB2,2021,8000000,-12000000
776798,Abdallah Sima,Stoke City,11000000,Wypożyczenie,GB2,2021,7000000,-4000000
226049,Freddie Woodman,AFC Bournemouth,10000000,Wypożyczenie,GB2,2021,6000000,-4000000
226049,Freddie Woodman,Swansea City,3000000,Wypożyczenie,GB2,2020,6000000,3000000
226049,Freddie Woodman,Swansea City,500000,Wypożyczenie,GB2,2019,6000000,5500000
503680,Neco Williams,FC Fulham,8000000,Wypożyczenie,GB2,2021,18000000,10000000
371814,Nathaniel Phillips,AFC Bournemouth,8000000,Wypożyczenie,GB2,2021,6000000,-2000000
325887,Filip Uremovic,Sheffield United,7000000,Wypożyczenie,GB2,2021,2000000,-5000000
429014,Morgan Gibbs-White,Sheffield United,7000000,Wypożyczenie,GB2,2021,30000000,23000000
429014,Morgan Gibbs-White,Swansea City,7000000,Wypożyczenie,GB2,2020,30000000,23000000
179860,Andraz Sporar,FC Middlesbrough,5000000,Wypożyczenie,GB2,2021,5000000,0
321070,Hannes Wolf,Swansea City,5000000,Wypożyczenie,GB2,2021,4000000,-1000000
404584,Marcus Forss,Hull City,4000000,Wypożyczenie,GB2,2021,3000000,-1000000
404584,Marcus Forss,AFC Wimbledon,150000,Wypożyczenie,GB3,2019,3000000,2850000
120565,Andre Gray,Queens Park Rangers,4000000,Wypożyczenie,GB2,2021,2000000,-2000000
344830,Tahith Chong,Birmingham City,4000000,Wypożyczenie,GB2,2021,3000000,-1000000
453824,Josh Maja,Stoke City,4000000,Wypożyczenie,GB2,2021,4000000,0
503770,Folarin Balogun,FC Middlesbrough,4000000,Wypożyczenie,GB2,2021,25000000,21000000
346291,James Léa Siliki,FC Middlesbrough,4000000,Wypożyczenie,GB2,2021,1000000,-3000000
505219,James Garner,Nottingham Forest,4000000,Wypożyczenie,GB2,2021,14000000,10000000
505219,James Garner,Nottingham Forest,3000000,Wypożyczenie,GB2,2020,14000000,11000000
505219,James Garner,FC Watford,2000000,Wypożyczenie,GB2,2020,14000000,12000000
338032,Deyovaisio Zeefuik,Blackburn Rovers,3000000,Wypożyczenie,GB2,2021,1000000,-2000000
128906,Liam Moore,Stoke City,3000000,Wypożyczenie,GB2,2021,1000000,-2000000
61653,Conor Hourihane,Sheffield United,3000000,Wypożyczenie,GB2,2021,700000,-2300000
61653,Conor Hourihane,Swansea City,6000000,Wypożyczenie,GB2,2020,700000,-5300000
618901,Sam McCallum,Queens Park Rangers,3000000,Wypożyczenie,GB2,2021,3000000,0
618901,Sam McCallum,Coventry City,750000,Wypożyczenie,GB2,2020,3000000,2250000
618901,Sam McCallum,Coventry City,0,Wypożyczenie,GB3,2019,3000000,3000000
73491,Danny Drinkwater,FC Reading,3000000,Wypożyczenie,GB2,2021,400000,-2600000
480975,Allahyar Sayyadmanesh,Hull City,3000000,Wypożyczenie,GB2,2021,4000000,1000000
75458,Robin Olsen,Sheffield United,3000000,Wypożyczenie,GB2,2021,2000000,-1000000
271098,Philip Zinckernagel,Nottingham Forest,3000000,Wypożyczenie,GB2,2021,3000000,0
199528,Josh Murphy,Preston North End,3000000,Wypożyczenie,GB2,2021,900000,-2100000
257097,Ben Davies,Sheffield United,3000000,Wypożyczenie,GB2,2021,3000000,0
258885,Max Lowe,Nottingham Forest,3000000,Wypożyczenie,GB2,2021,3000000,0
236510,Sheyi Ojo,FC Millwall,3000000,Wypożyczenie,GB2,2021,1000000,-2000000
236510,Sheyi Ojo,Cardiff City,1000000,Wypożyczenie,GB2,2020,1000000,0
367284,Leo Östigard,Stoke City,3000000,Wypożyczenie,GB2,2021,7000000,4000000
367284,Leo Östigard,Coventry City,2000000,Wypożyczenie,GB2,2020,7000000,5000000
307497,Matt Clarke,West Bromwich Albion,3000000,Wypożyczenie,GB2,2021,4000000,1000000
307497,Matt Clarke,Derby County,2000000,Wypożyczenie,GB2,2020,4000000,2000000
307497,Matt Clarke,Derby County,200000,Wypożyczenie,GB2,2019,4000000,3800000
576314,Jan Paul van Hecke,Blackburn Rovers,2000000,Wypożyczenie,GB2,2021,4000000,2000000
109751,Onel Hernández,FC Middlesbrough,2000000,Wypożyczenie,GB2,2021,1000000,-1000000
109751,Onel Hernández,Birmingham City,1000000,Wypożyczenie,GB2,2021,1000000,0
113036,Romaine Sawyers,Stoke City,2000000,Wypożyczenie,GB2,2021,1000000,-1000000
316551,Jake Clarke-Salter,Coventry City,2000000,Wypożyczenie,GB2,2021,2000000,0
316551,Jake Clarke-Salter,Birmingham City,2000000,Wypożyczenie,GB2,2020,2000000,0
316551,Jake Clarke-Salter,Birmingham City,2000000,Wypożyczenie,GB2,2019,2000000,0
483348,Djed Spence,Nottingham Forest,2000000,Wypożyczenie,GB2,2021,13000000,11000000
291544,Jordan Hugill,West Bromwich Albion,2000000,Wypożyczenie,GB2,2021,900000,-1100000
291544,Jordan Hugill,Cardiff City,1000000,Wypożyczenie,GB2,2021,900000,-100000
291544,Jordan Hugill,Queens Park Rangers,6000000,Wypożyczenie,GB2,2019,900000,-5100000
291544,Jordan Hugill,FC Middlesbrough,8000000,Wypożyczenie,GB2,2018,900000,-7100000
548470,Teden Mengi,Birmingham City,2000000,Wypożyczenie,GB2,2021,2000000,0
548470,Teden Mengi,Derby County,1000000,Wypożyczenie,GB2,2020,2000000,1000000
506009,Amine Bassi,FC Barnsley,1000000,Wypożyczenie,GB2,2021,1000000,0
110858,Benik Afobe,FC Millwall,1000000,Wypożyczenie,GB2,2021,1000000,0
110858,Benik Afobe,Bristol City,8000000,Wypożyczenie,GB2,2019,1000000,-7000000
110858,Benik Afobe,Stoke City,10000000,Wypożyczenie,GB2,2018,1000000,-9000000
66923,Luke Freeman,FC Millwall,1000000,Wypożyczenie,GB2,2021,900000,-100000
66923,Luke Freeman,Nottingham Forest,2000000,Wypożyczenie,GB2,2020,900000,-1100000
397099,Jordi Osei-Tutu,Nottingham Forest,1000000,Wypożyczenie,GB2,2021,1000000,0
397099,Jordi Osei-Tutu,Rotherham United,1000000,Wypożyczenie,GB3,2021,1000000,0
397099,Jordi Osei-Tutu,Cardiff City,1000000,Wypożyczenie,GB2,2020,1000000,0
314362,Hayden Coulson,Peterborough United,1000000,Wypożyczenie,GB2,2021,700000,-300000
314362,Hayden Coulson,Ipswich Town,1000000,Wypożyczenie,GB3,2021,700000,-300000
314362,Hayden Coulson,Cambridge United,100000,Wypożyczenie,GB4,2018,700000,600000
260841,Daniel Iversen,Preston North End,1000000,Wypożyczenie,GB2,2021,2000000,1000000
260841,Daniel Iversen,Preston North End,600000,Wypożyczenie,GB2,2020,2000000,1400000
260841,Daniel Iversen,Rotherham United,500000,Wypożyczenie,GB3,2019,2000000,1500000
260841,Daniel Iversen,Oldham Athletic,50000,Wypożyczenie,GB4,2018,2000000,1950000
365877,Matt Smith,Hull City,1000000,Wypożyczenie,GB2,2021,400000,-600000
365877,Matt Smith,Doncaster Rovers,900000,Wypożyczenie,GB3,2020,400000,-500000
365877,Matt Smith,Queens Park Rangers,1000000,Wypożyczenie,GB2,2019,400000,-600000
365877,Matt Smith,Charlton Athletic,1000000,Wypożyczenie,GB2,2019,400000,-600000
157368,Tom Ince,FC Reading,1000000,Wypożyczenie,GB2,2021,1000000,0
157368,Tom Ince,Luton Town,2000000,Wypożyczenie,GB2,2020,1000000,-1000000
805835,Rémy Vita,FC Barnsley,1000000,Wypożyczenie,GB2,2021,800000,-200000
357656,Jayson Molumby,West Bromwich Albion,1000000,Wypożyczenie,GB2,2021,2000000,1000000
357656,Jayson Molumby,Preston North End,900000,Wypożyczenie,GB2,2020,2000000,1100000
357656,Jayson Molumby,FC Millwall,0,Wypożyczenie,GB2,2019,2000000,2000000
158623,Cyrus Christie,Swansea City,1000000,Wypożyczenie,GB2,2021,1000000,0
158623,Cyrus Christie,Nottingham Forest,1000000,Wypożyczenie,GB2,2020,1000000,0
245765,Uche Ikpeazu,Cardiff City,800000,Wypożyczenie,GB2,2021,700000,-100000
596446,Leif Davis,AFC Bournemouth,800000,Wypożyczenie,GB2,2021,1000000,200000
110867,Jed Steer,Luton Town,800000,Wypożyczenie,GB2,2021,600000,-200000
110867,Jed Steer,Charlton Athletic,500000,Wypożyczenie,GB3,2018,600000,100000
608175,Alfie Doughty,Cardiff City,700000,Wypożyczenie,GB2,2021,1000000,300000
104495,Lyle Taylor,Birmingham City,700000,Wypożyczenie,GB2,2021,350000,-350000
349567,Juan Familia-Castillo,Birmingham City,700000,Wypożyczenie,GB2,2021,500000,-200000
349567,Juan Familia-Castillo,Charlton Athletic,500000,Wypożyczenie,GB3,2021,500000,0
346472,Tom Dele-Bashiru,FC Reading,700000,Wypożyczenie,GB2,2021,2000000,1300000
164499,Matt Ingram,Luton Town,600000,Wypożyczenie,GB2,2021,1000000,400000
164499,Matt Ingram,Wycombe Wanderers,250000,Wypożyczenie,GB3,2018,1000000,750000
493513,Karl Hein,FC Reading,450000,Wypożyczenie,GB2,2021,1000000,550000
395239,Claudio Gomes,FC Barnsley,450000,Wypożyczenie,GB2,2021,1000000,550000
314998,Liam Walsh,Hull City,400000,Wypożyczenie,GB2,2021,350000,-50000
314998,Liam Walsh,Coventry City,800000,Wypożyczenie,GB3,2019,350000,-450000
581681,Finley Burns,Swansea City,300000,Wypożyczenie,GB2,2021,300000,0
342050,Nathan Baxter,Hull City,300000,Wypożyczenie,GB2,2021,600000,300000
342050,Nathan Baxter,Accrington Stanley,75000,Wypożyczenie,GB3,2020,600000,525000
342050,Nathan Baxter,Yeovil Town,0,Wypożyczenie,GB4,2018,600000,600000
381469,Steven Benda,Peterborough United,250000,Wypożyczenie,GB2,2021,400000,150000
381469,Steven Benda,Swindon Town,100000,Wypożyczenie,GB4,2019,400000,300000
236493,Reece Brown,Peterborough United,250000,Wypożyczenie,GB2,2021,200000,-50000
236493,Reece Brown,Peterborough United,150000,Wypożyczenie,GB3,2020,200000,50000
236493,Reece Brown,Peterborough United,150000,Wypożyczenie,GB3,2019,200000,50000
245625,Alex Palmer,Luton Town,250000,Wypożyczenie,GB2,2021,500000,250000
245625,Alex Palmer,Lincoln City,0,Wypożyczenie,GB3,2020,500000,500000
245625,Alex Palmer,Plymouth Argyle,0,Wypożyczenie,GB4,2019,500000,500000
245625,Alex Palmer,Notts County,0,Wypożyczenie,GB4,2018,500000,500000
245625,Alex Palmer,Oldham Athletic,0,Wypożyczenie,GB4,2018,500000,500000
470606,Leighton Clarkson,Blackburn Rovers,150000,Wypożyczenie,GB2,2021,800000,650000
386752,Ryan Wintle,FC Blackpool,50000,Wypożyczenie,GB2,2021,3000000,2950000
512175,Ryan Longman,Hull City,0,Wypożyczenie,GB2,2021,2000000,2000000
512175,Ryan Longman,AFC Wimbledon,0,Wypożyczenie,GB3,2020,2000000,2000000
492690,Callum Morton,Peterborough United,0,Wypożyczenie,GB2,2021,250000,250000
492690,Callum Morton,Fleetwood Town,0,Wypożyczenie,GB3,2021,250000,250000
492690,Callum Morton,Lincoln City,0,Wypożyczenie,GB3,2020,250000,250000
492690,Callum Morton,Northampton Town,0,Wypożyczenie,GB4,2019,250000,250000
614258,Levi Colwill,Huddersfield Town,0,Wypożyczenie,GB2,2021,16000000,16000000
503686,Daniel Ballard,FC Millwall,0,Wypożyczenie,GB2,2021,2000000,2000000
503686,Daniel Ballard,FC Blackpool,0,Wypożyczenie,GB3,2020,2000000,2000000
503686,Daniel Ballard,Swindon Town,0,Wypożyczenie,GB4,2019,2000000,2000000
559794,Jack Clarke,AFC Sunderland,5000000,Wypożyczenie,GB3,2021,8000000,3000000
559794,Jack Clarke,Stoke City,5000000,Wypożyczenie,GB2,2020,8000000,3000000
559794,Jack Clarke,Leeds United,6000000,Wypożyczenie,GB2,2019,8000000,2000000
559794,Jack Clarke,Queens Park Rangers,6000000,Wypożyczenie,GB2,2019,8000000,2000000
120504,Harlee Dean,Sheffield Wednesday,2000000,Wypożyczenie,GB3,2021,600000,-1400000
296577,Macauley Bonne,Ipswich Town,2000000,Wypożyczenie,GB3,2021,500000,-1500000
55742,Harry Arter,Charlton Athletic,2000000,Wypożyczenie,GB3,2021,600000,-1400000
55742,Harry Arter,FC Fulham,7000000,Wypożyczenie,GB2,2019,600000,-6400000
268117,Mahlon Romeo,FC Portsmouth,2000000,Wypożyczenie,GB3,2021,2000000,0
517286,Lewis Wing,Sheffield Wednesday,2000000,Wypożyczenie,GB3,2021,500000,-1500000
517286,Lewis Wing,Rotherham United,2000000,Wypożyczenie,GB2,2020,500000,-1500000
483974,Leon Dajaku,AFC Sunderland,1000000,Wypożyczenie,GB3,2021,900000,-100000
435198,Jordan Storey,Sheffield Wednesday,1000000,Wypożyczenie,GB3,2021,3000000,2000000
314266,Jonathan Leko,Charlton Athletic,1000000,Wypożyczenie,GB3,2021,500000,-500000
314266,Jonathan Leko,Charlton Athletic,1000000,Wypożyczenie,GB2,2019,500000,-500000
365544,Pontus Dahlberg,FC Gillingham,1000000,Wypożyczenie,GB3,2021,1000000,0
365544,Pontus Dahlberg,Doncaster Rovers,1000000,Wypożyczenie,GB3,2021,1000000,0
106676,Will Grigg,Rotherham United,1000000,Wypożyczenie,GB3,2021,350000,-650000
106676,Will Grigg,Milton Keynes Dons,1000000,Wypożyczenie,GB3,2020,350000,-650000
542690,Frederik Alves,AFC Sunderland,1000000,Wypożyczenie,GB3,2021,600000,-400000
746740,Daniel Jebbison,Burton Albion,1000000,Wypożyczenie,GB3,2021,1000000,0
410436,Bailey Peacock-Farrell,Sheffield Wednesday,1000000,Wypożyczenie,GB3,2021,900000,-100000
425716,Tyreeq Bakinson,Ipswich Town,1000000,Wypożyczenie,GB3,2021,700000,-300000
425716,Tyreeq Bakinson,Plymouth Argyle,250000,Wypożyczenie,GB4,2019,700000,450000
425716,Tyreeq Bakinson,Newport County,0,Wypożyczenie,GB4,2018,700000,700000
503688,Dominic Thompson,Ipswich Town,800000,Wypożyczenie,GB3,2021,1000000,200000
503688,Dominic Thompson,Swindon Town,400000,Wypożyczenie,GB3,2020,1000000,600000
325588,Gavin Whyte,Oxford United,800000,Wypożyczenie,GB3,2021,600000,-200000
325588,Gavin Whyte,Hull City,1000000,Wypożyczenie,GB3,2020,600000,-400000
208379,Christian Walton,Ipswich Town,800000,Wypożyczenie,GB3,2021,1000000,200000
208379,Christian Walton,Blackburn Rovers,1000000,Wypożyczenie,GB2,2019,1000000,0
208379,Christian Walton,Wigan Athletic,250000,Wypożyczenie,GB2,2018,1000000,750000
425799,Tom Bayliss,Wigan Athletic,700000,Wypożyczenie,GB3,2021,350000,-350000
314253,Herbie Kane,Oxford United,700000,Wypożyczenie,GB3,2021,900000,200000
314253,Herbie Kane,Hull City,250000,Wypożyczenie,GB2,2019,900000,650000
314253,Herbie Kane,Doncaster Rovers,0,Wypożyczenie,GB3,2018,900000,900000
433185,Xavier Amaechi,Bolton Wanderers,600000,Wypożyczenie,GB3,2021,500000,-100000
229826,Elliot Lee,Charlton Athletic,600000,Wypożyczenie,GB3,2021,0,-600000
229826,Elliot Lee,Oxford United,900000,Wypożyczenie,GB3,2020,0,-900000
317444,Ron-Thorben Hoffmann,AFC Sunderland,600000,Wypożyczenie,GB3,2021,400000,-200000
284020,Florian Kamberi,Sheffield Wednesday,550000,Wypożyczenie,GB3,2021,450000,-100000
341295,Tyler Walker,FC Portsmouth,500000,Wypożyczenie,GB3,2021,300000,-200000
341295,Tyler Walker,Lincoln City,250000,Wypożyczenie,GB3,2019,300000,50000
341295,Tyler Walker,Mansfield Town,250000,Wypożyczenie,GB4,2018,300000,50000
314268,Jacob Maddox,Burton Albion,500000,Wypożyczenie,GB3,2021,250000,-250000
314268,Jacob Maddox,Tranmere Rovers,0,Wypożyczenie,GB3,2019,250000,250000
314268,Jacob Maddox,Cheltenham Town,0,Wypożyczenie,GB4,2018,250000,250000
453661,Jacob Bedeau,FC Morecambe,450000,Wypożyczenie,GB3,2021,350000,-100000
289844,Josh Harrop,Fleetwood Town,400000,Wypożyczenie,GB3,2021,250000,-150000
289844,Josh Harrop,Ipswich Town,700000,Wypożyczenie,GB3,2020,250000,-450000
348488,Harry Chapman,Burton Albion,400000,Wypożyczenie,GB3,2021,300000,-100000
348488,Harry Chapman,Shrewsbury Town,300000,Wypożyczenie,GB3,2020,300000,0
258199,Ethan Robson,Milton Keynes Dons,400000,Wypożyczenie,GB3,2021,250000,-150000
258199,Ethan Robson,Grimsby Town,500000,Wypożyczenie,GB4,2019,250000,-250000
611845,Ciaron Brown,Oxford United,400000,Wypożyczenie,GB3,2021,350000,-50000
41131,Trevor Carson,FC Morecambe,350000,Wypożyczenie,GB3,2021,350000,0
411255,Jordan Thorniley,Oxford United,300000,Wypożyczenie,GB3,2021,700000,400000
123672,Tomas Holy,Cambridge United,300000,Wypożyczenie,GB3,2021,250000,-50000
123672,Tomas Holy,Port Vale FC,300000,Wypożyczenie,GB4,2021,250000,-50000
296978,Liam Cullen,Lincoln City,300000,Wypożyczenie,GB3,2021,1000000,700000
381156,Joel Mumbongo,Accrington Stanley,300000,Wypożyczenie,GB3,2021,200000,-100000
624948,Mattie Pollock,Cheltenham Town,250000,Wypożyczenie,GB3,2021,300000,50000
530879,Kayne Ramsay,Crewe Alexandra,250000,Wypożyczenie,GB3,2021,200000,-50000
530879,Kayne Ramsay,Shrewsbury Town,0,Wypożyczenie,GB3,2019,200000,200000
380029,Ryan Broom,Plymouth Argyle,250000,Wypożyczenie,GB3,2021,350000,100000
380029,Ryan Broom,Burton Albion,0,Wypożyczenie,GB3,2020,350000,350000
550829,Matej Kovar,Burton Albion,250000,Wypożyczenie,GB3,2021,900000,650000
550829,Matej Kovar,Swindon Town,250000,Wypożyczenie,GB3,2020,900000,650000
503780,Hayden Carter,FC Portsmouth,250000,Wypożyczenie,GB3,2021,800000,550000
503780,Hayden Carter,Burton Albion,150000,Wypożyczenie,GB3,2020,800000,650000
581683,Nile John,Charlton Athletic,200000,Wypożyczenie,GB3,2021,400000,200000
595652,Peter Kioso,Milton Keynes Dons,200000,Wypożyczenie,GB3,2021,300000,100000
595652,Peter Kioso,Northampton Town,100000,Wypożyczenie,GB3,2020,300000,200000
595652,Peter Kioso,Bolton Wanderers,100000,Wypożyczenie,GB4,2020,300000,200000
639763,Rodrigo Vilca,Doncaster Rovers,200000,Wypożyczenie,GB3,2021,350000,150000
424021,Dapo Mebude,AFC Wimbledon,200000,Wypożyczenie,GB3,2021,300000,100000
344586,Connal Trueman,Oxford United,200000,Wypożyczenie,GB3,2021,200000,0
344586,Connal Trueman,Swindon Town,250000,Wypożyczenie,GB3,2020,200000,-50000
344586,Connal Trueman,AFC Wimbledon,250000,Wypożyczenie,GB3,2020,200000,-50000
545432,Marcel Lewis,Accrington Stanley,150000,Wypożyczenie,GB3,2021,150000,0
444571,Curtis Tilt,Wigan Athletic,150000,Wypożyczenie,GB3,2021,400000,250000
444571,Curtis Tilt,Wigan Athletic,100000,Wypożyczenie,GB3,2020,400000,300000
309041,Zak Jules,Fleetwood Town,100000,Wypożyczenie,GB3,2021,200000,100000
504396,Christian Norton,Cheltenham Town,100000,Wypożyczenie,GB3,2021,150000,50000
425713,Akin Famewo,Charlton Athletic,100000,Wypożyczenie,GB3,2021,300000,200000
425713,Akin Famewo,Charlton Athletic,25000,Wypożyczenie,GB3,2020,300000,275000
425713,Akin Famewo,Grimsby Town,25000,Wypożyczenie,GB4,2018,300000,275000
646996,Daniel Phillips,FC Gillingham,100000,Wypożyczenie,GB3,2021,100000,0
314381,Adam Phillips,FC Morecambe,75000,Wypożyczenie,GB3,2021,450000,375000
314381,Adam Phillips,Accrington Stanley,75000,Wypożyczenie,GB3,2020,450000,375000
314381,Adam Phillips,FC Morecambe,75000,Wypożyczenie,GB4,2020,450000,375000
314381,Adam Phillips,FC Morecambe,75000,Wypożyczenie,GB4,2019,450000,375000
424014,Josh McPake,FC Morecambe,75000,Wypożyczenie,GB3,2021,125000,50000
424014,Josh McPake,Tranmere Rovers,75000,Wypożyczenie,GB4,2021,125000,50000
424014,Josh McPake,Harrogate Town,75000,Wypożyczenie,GB4,2020,125000,50000
565682,Matthew Bondswell,Shrewsbury Town,50000,Wypożyczenie,GB3,2021,50000,0
507235,Jack Young,Wycombe Wanderers,0,Wypożyczenie,GB3,2021,150000,150000
507235,Jack Young,Tranmere Rovers,0,Wypożyczenie,GB4,2020,150000,150000
603937,Callum Jones,FC Morecambe,0,Wypożyczenie,GB3,2021,100000,100000
366834,Callum Johnson,Fleetwood Town,0,Wypożyczenie,GB3,2021,300000,300000
447063,Archie Mair,Lincoln City,0,Wypożyczenie,GB3,2021,0,0
624967,Kion Etete,Cheltenham Town,0,Wypożyczenie,GB3,2021,900000,900000
624967,Kion Etete,Northampton Town,0,Wypożyczenie,GB4,2021,900000,900000
502830,Callum Wright,Cheltenham Town,0,Wypożyczenie,GB3,2021,500000,500000
502830,Callum Wright,Cheltenham Town,0,Wypożyczenie,GB4,2020,500000,500000
610649,Ryan Alebiosu,Crewe Alexandra,0,Wypożyczenie,GB3,2021,350000,350000
559806,Ryan Edmondson,Fleetwood Town,0,Wypożyczenie,GB3,2021,200000,200000
559806,Ryan Edmondson,Port Vale FC,0,Wypożyczenie,GB4,2021,200000,200000
559806,Ryan Edmondson,Northampton Town,0,Wypożyczenie,GB3,2020,200000,200000
395797,Sam Hughes,Burton Albion,0,Wypożyczenie,GB3,2021,350000,350000
395797,Sam Hughes,Burton Albion,0,Wypożyczenie,GB3,2020,350000,350000
395797,Sam Hughes,Salford City,0,Wypożyczenie,GB4,2019,350000,350000
594276,Tiago Cukur,Doncaster Rovers,0,Wypożyczenie,GB3,2021,250000,250000
566799,James Trafford,Accrington Stanley,0,Wypożyczenie,GB3,2021,2000000,2000000
566799,James Trafford,Bolton Wanderers,0,Wypożyczenie,GB3,2021,2000000,2000000
689892,Ben Jackson,Doncaster Rovers,0,Wypożyczenie,GB3,2021,0,0
689892,Ben Jackson,Bolton Wanderers,0,Wypożyczenie,GB4,2020,0,0
671073,Jovan Malcolm,Accrington Stanley,0,Wypożyczenie,GB3,2021,0,0
434015,Terry Ablade,AFC Wimbledon,0,Wypożyczenie,GB3,2021,200000,200000
585550,Gavin Bazunu,FC Portsmouth,0,Wypożyczenie,GB3,2021,18000000,18000000
585550,Gavin Bazunu,AFC Rochdale,0,Wypożyczenie,GB3,2020,18000000,18000000
530740,Yeboah Amankwah,Accrington Stanley,0,Wypożyczenie,GB3,2021,350000,350000
530740,Yeboah Amankwah,AFC Rochdale,0,Wypożyczenie,GB3,2020,350000,350000
406636,Jamie Soule,Cheltenham Town,0,Wypożyczenie,GB3,2021,0,0
406636,Jamie Soule,Lincoln City,0,Wypożyczenie,GB3,2020,0,0
874080,Mason Burstow,Charlton Athletic,0,Wypożyczenie,GB3,2021,200000,200000
820970,Sam Sherring,Cambridge United,0,Wypożyczenie,GB3,2021,300000,300000
820970,Sam Sherring,Accrington Stanley,0,Wypożyczenie,GB3,2021,300000,300000
554174,J'Neil Bennett,Crewe Alexandra,0,Wypożyczenie,GB3,2021,0,0
337321,Nathan Holland,Oxford United,0,Wypożyczenie,GB3,2021,400000,400000
337321,Nathan Holland,Oxford United,0,Wypożyczenie,GB3,2019,400000,400000
568007,Ben Knight,Crewe Alexandra,0,Wypożyczenie,GB3,2021,300000,300000
633258,Tomas Kalinauskas,AFC Wimbledon,0,Wypożyczenie,GB3,2021,100000,100000
408562,Marlon Fossey,Bolton Wanderers,0,Wypożyczenie,GB3,2021,2000000,2000000
408562,Marlon Fossey,Shrewsbury Town,0,Wypożyczenie,GB3,2020,2000000,2000000
536533,Scott Robertson,Crewe Alexandra,0,Wypożyczenie,GB3,2021,200000,200000
536533,Scott Robertson,Doncaster Rovers,0,Wypożyczenie,GB3,2020,200000,200000
536533,Scott Robertson,FC Gillingham,0,Wypożyczenie,GB3,2020,200000,200000
528894,Matt Smith,Doncaster Rovers,0,Wypożyczenie,GB3,2021,350000,350000
528894,Matt Smith,Charlton Athletic,0,Wypożyczenie,GB3,2020,350000,350000
528894,Matt Smith,Swindon Town,0,Wypożyczenie,GB3,2020,350000,350000
614084,Luke Matheson,Scunthorpe United,600000,Wypożyczenie,GB4,2021,600000,0
614084,Luke Matheson,Ipswich Town,900000,Wypożyczenie,GB3,2020,600000,-300000
614084,Luke Matheson,AFC Rochdale,0,Wypożyczenie,GB3,2019,600000,600000
51730,Jamie Murphy,Mansfield Town,550000,Wypożyczenie,GB4,2021,450000,-100000
51730,Jamie Murphy,Burton Albion,1000000,Wypożyczenie,GB3,2019,450000,-550000
399473,Luke Thomas,Bristol Rovers,500000,Wypożyczenie,GB4,2021,500000,0
399473,Luke Thomas,Ipswich Town,800000,Wypożyczenie,GB3,2020,500000,-300000
399473,Luke Thomas,Coventry City,0,Wypożyczenie,GB3,2018,500000,500000
403572,Stephen Kelly,Salford City,400000,Wypożyczenie,GB4,2021,400000,0
46805,Tom Elliott,Bradford City,400000,Wypożyczenie,GB4,2021,150000,-250000
72518,Jamie Walker,Bradford City,400000,Wypożyczenie,GB4,2021,350000,-50000
72518,Jamie Walker,Peterborough United,750000,Wypożyczenie,GB3,2018,350000,-400000
69755,Michael Bostwick,FC Stevenage,325000,Wypożyczenie,GB4,2021,125000,-200000
339789,Josh Pask,Newport County,300000,Wypożyczenie,GB4,2021,100000,-200000
495033,Nathan Bishop,Mansfield Town,300000,Wypożyczenie,GB4,2021,300000,0
57070,Frank Fielding,Salford City,300000,Wypożyczenie,GB4,2021,250000,-50000
68333,Padraig Amond,Exeter City,300000,Wypożyczenie,GB4,2021,0,-300000
251056,Cameron Dawson,Exeter City,300000,Wypożyczenie,GB4,2021,450000,150000
125689,Laurie Walker,Oldham Athletic,250000,Wypożyczenie,GB4,2021,0,-250000
125689,Laurie Walker,Oldham Athletic,250000,Wypożyczenie,GB4,2020,0,-250000
119123,Frank Nouble,Leyton Orient,250000,Wypożyczenie,GB4,2021,250000,0
119123,Frank Nouble,Colchester United,250000,Wypożyczenie,GB4,2020,250000,0
486001,Stephen Walker,Tranmere Rovers,250000,Wypożyczenie,GB4,2021,200000,-50000
486001,Stephen Walker,Crewe Alexandra,250000,Wypożyczenie,GB3,2020,200000,-50000
486001,Stephen Walker,Milton Keynes Dons,250000,Wypożyczenie,GB3,2020,200000,-50000
486001,Stephen Walker,Crewe Alexandra,250000,Wypożyczenie,GB4,2019,200000,-50000
486001,Stephen Walker,Milton Keynes Dons,0,Wypożyczenie,GB4,2018,200000,200000
285283,Ross Doohan,Tranmere Rovers,250000,Wypożyczenie,GB4,2021,250000,0
503683,Anthony Driscoll-Glennon,AFC Barrow,250000,Wypożyczenie,GB4,2021,250000,0
503683,Anthony Driscoll-Glennon,Grimsby Town,0,Wypożyczenie,GB4,2019,250000,250000
113034,Paul Downing,AFC Rochdale,250000,Wypożyczenie,GB4,2021,250000,0
113034,Paul Downing,Doncaster Rovers,250000,Wypożyczenie,GB3,2018,250000,0
62642,Nathan Delfouneso,Bradford City,250000,Wypożyczenie,GB4,2021,250000,0
428041,Tyler Magloire,Northampton Town,250000,Wypożyczenie,GB4,2021,250000,0
428041,Tyler Magloire,AFC Rochdale,0,Wypożyczenie,GB3,2019,250000,250000
387391,Myles Kenlock,Colchester United,250000,Wypożyczenie,GB4,2021,250000,0
236508,Bryn Morris,Hartlepool United,250000,Wypożyczenie,GB4,2021,150000,-100000
236508,Bryn Morris,Northampton Town,250000,Wypożyczenie,GB3,2020,150000,-100000
236508,Bryn Morris,Wycombe Wanderers,250000,Wypożyczenie,GB3,2018,150000,-100000
163531,Connor Ripley,Salford City,250000,Wypożyczenie,GB4,2021,350000,100000
163531,Connor Ripley,Accrington Stanley,250000,Wypożyczenie,GB3,2018,350000,100000
612163,Faysal Bettache,Oldham Athletic,200000,Wypożyczenie,GB4,2021,200000,0
804040,George Broadbent,AFC Rochdale,200000,Wypożyczenie,GB4,2021,0,-200000
186574,Aaron Amadi-Holloway,AFC Barrow,200000,Wypożyczenie,GB4,2021,0,-200000
610297,Tyler Burey,Hartlepool United,200000,Wypożyczenie,GB4,2021,900000,700000
567576,Elliot Anderson,Bristol Rovers,200000,Wypożyczenie,GB4,2021,3000000,2800000
606006,Alex Hunt,Oldham Athletic,200000,Wypożyczenie,GB4,2021,150000,-50000
396861,Richard Nartey,Mansfield Town,200000,Wypożyczenie,GB4,2021,150000,-50000
396861,Richard Nartey,Burton Albion,0,Wypożyczenie,GB3,2019,150000,150000
696892,Blondy Nna Noukeu,Crawley Town,150000,Wypożyczenie,GB4,2021,150000,0
504617,Oliver Cooper,Newport County,150000,Wypożyczenie,GB4,2021,2000000,1850000
470608,Reece Devine,FC Walsall,150000,Wypożyczenie,GB4,2021,150000,0
654173,Brad Young,Carlisle United,150000,Wypożyczenie,GB4,2021,200000,50000
503750,Dominic Revan,Northampton Town,150000,Wypożyczenie,GB4,2021,0,-150000
703661,Nicholas Bilokapic,Hartlepool United,150000,Wypożyczenie,GB4,2021,200000,50000
405982,Idris Kanu,Northampton Town,150000,Wypożyczenie,GB4,2021,0,-150000
405982,Idris Kanu,Port Vale FC,75000,Wypożyczenie,GB4,2018,0,-75000
503989,Jeriel Dorsett,AFC Rochdale,150000,Wypożyczenie,GB4,2021,250000,100000
344589,Jack Aitchison,Forest Green Rovers,100000,Wypożyczenie,GB4,2021,200000,100000
344589,Jack Aitchison,FC Stevenage,0,Wypożyczenie,GB4,2020,200000,200000
344589,Jack Aitchison,Forest Green Rovers,0,Wypożyczenie,GB4,2019,200000,200000
723667,Brahima Diarra,Harrogate Town,100000,Wypożyczenie,GB4,2021,300000,200000
805494,Jake Hull,Hartlepool United,100000,Wypożyczenie,GB4,2021,100000,0
485996,Isaac Hutchinson,Crawley Town,100000,Wypożyczenie,GB4,2021,300000,200000
485996,Isaac Hutchinson,Forest Green Rovers,0,Wypożyczenie,GB4,2020,300000,300000
414892,George Miller,FC Walsall,100000,Wypożyczenie,GB4,2021,200000,100000
414892,George Miller,Scunthorpe United,100000,Wypożyczenie,GB4,2019,200000,100000
414892,George Miller,Bradford City,100000,Wypożyczenie,GB3,2018,200000,100000
694830,Festus Arthur,AFC Barrow,100000,Wypożyczenie,GB4,2021,0,-100000
684283,Zach Jeacock,Salford City,100000,Wypożyczenie,GB4,2021,100000,0
575212,Isaac Fletcher,Hartlepool United,100000,Wypożyczenie,GB4,2021,100000,0
460255,Max Melbourne,FC Stevenage,100000,Wypożyczenie,GB4,2021,150000,50000
460255,Max Melbourne,FC Walsall,100000,Wypożyczenie,GB4,2020,150000,50000
460255,Max Melbourne,Lincoln City,100000,Wypożyczenie,GB3,2019,150000,50000
316554,Ryan Delaney,Scunthorpe United,100000,Wypożyczenie,GB4,2021,200000,100000
316554,Ryan Delaney,AFC Wimbledon,100000,Wypożyczenie,GB3,2019,200000,100000
574037,Tom Billson,Scunthorpe United,100000,Wypożyczenie,GB4,2021,100000,0
334703,Jordan Flores,Northampton Town,100000,Wypożyczenie,GB4,2021,100000,0
809099,Owura Edwards,Exeter City,100000,Wypożyczenie,GB4,2021,350000,250000
809099,Owura Edwards,Colchester United,100000,Wypożyczenie,GB4,2021,350000,250000
809099,Owura Edwards,Grimsby Town,0,Wypożyczenie,GB4,2020,350000,350000
542884,Alex Gilbert,Swindon Town,100000,Wypożyczenie,GB4,2021,100000,0
192696,George Ray,Leyton Orient,100000,Wypożyczenie,GB4,2021,100000,0
538216,Hayden Hackney,Scunthorpe United,100000,Wypożyczenie,GB4,2021,2000000,1900000
457128,Jake Turner,Colchester United,100000,Wypożyczenie,GB4,2021,100000,0
457128,Jake Turner,FC Morecambe,100000,Wypożyczenie,GB4,2020,100000,0
671489,Amrit Bansal-McNulty,Crawley Town,100000,Wypożyczenie,GB4,2021,100000,0
366681,Lee O'Connor,Tranmere Rovers,100000,Wypożyczenie,GB4,2021,300000,200000
366681,Lee O'Connor,Tranmere Rovers,100000,Wypożyczenie,GB4,2020,300000,200000
747681,Isaac Olaofe,Sutton United,75000,Wypożyczenie,GB4,2021,150000,75000
334687,Alex Bass,Bradford City,50000,Wypożyczenie,GB4,2021,200000,150000
511561,Will Forrester,Mansfield Town,50000,Wypożyczenie,GB4,2021,450000,400000
711544,Jake O'Brien,Swindon Town,25000,Wypożyczenie,GB4,2021,500000,475000
504051,Jamie Bowden,Oldham Athletic,0,Wypożyczenie,GB4,2021,0,0
488416,Josh Hawkes,Tranmere Rovers,0,Wypożyczenie,GB4,2021,300000,300000
386936,Joel Cooper,Port Vale FC,0,Wypożyczenie,GB4,2021,100000,100000
655180,Jake Scrimshaw,Scunthorpe United,0,Wypożyczenie,GB4,2021,0,0
655180,Jake Scrimshaw,FC Walsall,0,Wypożyczenie,GB4,2020,0,0
655180,Jake Scrimshaw,Newport County,0,Wypożyczenie,GB4,2020,0,0
664581,Armando Dobra,Colchester United,0,Wypożyczenie,GB4,2021,0,0
567102,James Connolly,Bristol Rovers,0,Wypożyczenie,GB4,2021,300000,300000
725701,Dan Moss,Leyton Orient,0,Wypożyczenie,GB4,2021,0,0
506199,Timmy Abraham,Newport County,0,Wypożyczenie,GB4,2021,200000,200000
506199,Timmy Abraham,Plymouth Argyle,0,Wypożyczenie,GB3,2020,200000,200000
506199,Timmy Abraham,Bristol Rovers,0,Wypożyczenie,GB3,2019,200000,200000
718547,Josh Davison,Swindon Town,0,Wypożyczenie,GB4,2021,300000,300000
718547,Josh Davison,Forest Green Rovers,0,Wypożyczenie,GB4,2020,300000,300000
293709,Theo Archibald,Leyton Orient,0,Wypożyczenie,GB4,2021,250000,250000
293709,Theo Archibald,Forest Green Rovers,0,Wypożyczenie,GB4,2018,250000,250000
372525,Sam Hornby,Colchester United,0,Wypożyczenie,GB4,2021,75000,75000
565420,Jake Cain,Newport County,0,Wypożyczenie,GB4,2021,200000,200000
657259,Edward Jones,Hartlepool United,0,Wypożyczenie,GB4,2021,0,0
753894,Will Harris,AFC Barrow,0,Wypożyczenie,GB4,2021,0,0
504904,Zain Westbrooke,FC Stevenage,0,Wypożyczenie,GB4,2021,175000,175000
551309,Tyrese Omotoye,Leyton Orient,0,Wypożyczenie,GB4,2021,200000,200000
551309,Tyrese Omotoye,Carlisle United,0,Wypożyczenie,GB4,2021,200000,200000
551309,Tyrese Omotoye,Swindon Town,0,Wypożyczenie,GB3,2020,200000,200000
552615,Jacob Wakeling,AFC Barrow,0,Wypożyczenie,GB4,2021,300000,300000
860693,Corie Andrews,Colchester United,0,Wypożyczenie,GB4,2021,0,0
289791,Kieran O'Hara,Scunthorpe United,0,Wypożyczenie,GB4,2021,150000,150000
289791,Kieran O'Hara,Burton Albion,0,Wypożyczenie,GB3,2019,150000,150000
289791,Kieran O'Hara,Macclesfield Town FC,0,Wypożyczenie,GB4,2018,150000,150000
546904,Sam Burns,Scunthorpe United,0,Wypożyczenie,GB4,2021,0,0
496644,Ryan Stirk,Mansfield Town,0,Wypożyczenie,GB4,2021,0,0
337796,Offrande Zanzala,Exeter City,0,Wypożyczenie,GB4,2021,125000,125000
500687,Tyrese Shade,FC Walsall,0,Wypożyczenie,GB4,2021,300000,300000
504856,Will Ferry,Crawley Town,0,Wypożyczenie,GB4,2021,200000,200000
746094,Alex Mitchell,Leyton Orient,0,Wypożyczenie,GB4,2021,325000,325000
565684,George Shelvey,Mansfield Town,0,Wypożyczenie,GB4,2021,0,0
746622,Harry Wood,Scunthorpe United,0,Wypożyczenie,GB4,2021,0,0
344004,Cameron Coxe,Colchester United,0,Wypożyczenie,GB4,2021,0,0
496646,Sion Spence,Bristol Rovers,0,Wypożyczenie,GB4,2021,0,0
860694,Will Goodwin,Hartlepool United,0,Wypożyczenie,GB4,2021,150000,150000
476050,Rekeil Pyke,Scunthorpe United,0,Wypożyczenie,GB4,2021,250000,250000
476050,Rekeil Pyke,AFC Rochdale,0,Wypożyczenie,GB3,2019,250000,250000
476050,Rekeil Pyke,AFC Rochdale,0,Wypożyczenie,GB3,2018,250000,250000
474382,Lewis Cass,Port Vale FC,0,Wypożyczenie,GB4,2021,200000,200000
325214,Corey O'Keeffe,AFC Rochdale,0,Wypożyczenie,GB4,2021,250000,250000
325214,Corey O'Keeffe,Macclesfield Town FC,0,Wypożyczenie,GB4,2019,250000,250000
633388,Tyrese Sinclair,Scunthorpe United,0,Wypożyczenie,GB4,2021,0,0
853489,Mitchell Roberts,Carlisle United,0,Wypożyczenie,GB4,2021,0,0
853489,Mitchell Roberts,Harrogate Town,0,Wypożyczenie,GB4,2020,0,0
456293,Jonathan Dinzeyi,Carlisle United,0,Wypożyczenie,GB4,2021,0,0
712106,Connor Taylor,Bristol Rovers,0,Wypożyczenie,GB4,2021,1000000,1000000
602545,Bailey Clements,FC Stevenage,0,Wypożyczenie,GB4,2021,0,0
680653,Owen Windsor,Carlisle United,0,Wypożyczenie,GB4,2021,0,0
680653,Owen Windsor,Grimsby Town,0,Wypożyczenie,GB4,2020,0,0
680653,Owen Windsor,Newport County,0,Wypożyczenie,GB4,2020,0,0
664558,Tyreece Simpson,Swindon Town,0,Wypożyczenie,GB4,2021,300000,300000
404384,Rabbi Matondo,Stoke City,8000000,Wypożyczenie,GB2,2020,3000000,-5000000
504085,Tomás Esteves,FC Reading,8000000,Wypożyczenie,GB2,2020,1000000,-7000000
406638,Oliver Skipp,Norwich City,7000000,Wypożyczenie,GB2,2020,15000000,8000000
293168,Filip Benkovic,Cardiff City,7000000,Wypożyczenie,GB2,2020,1000000,-6000000
293168,Filip Benkovic,Bristol City,9000000,Wypożyczenie,GB2,2019,1000000,-8000000
287431,Alfie Mawson,Bristol City,7000000,Wypożyczenie,GB2,2020,0,-7000000
261988,Filip Krovinovic,Nottingham Forest,6000000,Wypożyczenie,GB2,2020,5000000,-1000000
261988,Filip Krovinovic,West Bromwich Albion,5000000,Wypożyczenie,GB2,2019,5000000,0
406008,Yan Valery,Birmingham City,6000000,Wypożyczenie,GB2,2020,2000000,-4000000
503733,Anthony Gordon,Preston North End,5000000,Wypożyczenie,GB2,2020,40000000,35000000
337807,Jordan Morris,Swansea City,5000000,Wypożyczenie,GB2,2020,5000000,0
315128,Carel Eiting,Huddersfield Town,4000000,Wypożyczenie,GB2,2020,2000000,-2000000
565822,Harvey Elliott,Blackburn Rovers,4000000,Wypożyczenie,GB2,2020,35000000,31000000
204102,Xavi Quintillà,Norwich City,4000000,Wypożyczenie,GB2,2020,1000000,-3000000
201574,Angus Gunn,Stoke City,4000000,Wypożyczenie,GB2,2020,3000000,-1000000
75471,Yannick Bolasie,FC Middlesbrough,3000000,Wypożyczenie,GB2,2020,250000,-2750000
75471,Yannick Bolasie,Aston Villa,18000000,Wypożyczenie,GB2,2018,250000,-17750000
135213,Kenneth Zohore,FC Millwall,3000000,Wypożyczenie,GB2,2020,700000,-2300000
129627,Charlie Austin,Queens Park Rangers,3000000,Wypożyczenie,GB2,2020,300000,-2700000
204294,Saman Ghoddos,FC Brentford,3000000,Wypożyczenie,GB2,2020,2000000,-1000000
638741,Daryl Dike,FC Barnsley,3000000,Wypożyczenie,GB2,2020,7000000,4000000
189876,Paul Arriola,Swansea City,3000000,Wypożyczenie,GB2,2020,4000000,1000000
37304,Shane Long,AFC Bournemouth,2000000,Wypożyczenie,GB2,2020,300000,-1700000
93831,Tom Trybull,Blackburn Rovers,2000000,Wypożyczenie,GB2,2020,800000,-1200000
225452,Patrick Roberts,FC Middlesbrough,2000000,Wypożyczenie,GB2,2020,2000000,0
225452,Patrick Roberts,Derby County,2000000,Wypożyczenie,GB2,2020,2000000,0
225452,Patrick Roberts,FC Middlesbrough,3000000,Wypożyczenie,GB2,2019,2000000,-1000000
392757,Marc Guéhi,Swansea City,2000000,Wypożyczenie,GB2,2020,35000000,33000000
392757,Marc Guéhi,Swansea City,1000000,Wypożyczenie,GB2,2019,35000000,34000000
268746,Jack Marriott,Sheffield Wednesday,2000000,Wypożyczenie,GB2,2020,700000,-1300000
461617,Rodrigo Riquelme,AFC Bournemouth,2000000,Wypożyczenie,GB2,2020,10000000,8000000
101682,Scott Malone,FC Millwall,2000000,Wypożyczenie,GB2,2020,1000000,-1000000
245805,Izzy Brown,Sheffield Wednesday,2000000,Wypożyczenie,GB2,2020,0,-2000000
245805,Izzy Brown,Luton Town,5000000,Wypożyczenie,GB2,2019,0,-5000000
245805,Izzy Brown,Leeds United,5000000,Wypożyczenie,GB2,2018,0,-5000000
341049,Cameron Carter-Vickers,AFC Bournemouth,2000000,Wypożyczenie,GB2,2020,11000000,9000000
341049,Cameron Carter-Vickers,Luton Town,2000000,Wypożyczenie,GB2,2019,11000000,9000000
341049,Cameron Carter-Vickers,Stoke City,1000000,Wypożyczenie,GB2,2019,11000000,10000000
341049,Cameron Carter-Vickers,Swansea City,1000000,Wypożyczenie,GB2,2018,11000000,10000000
91854,Barry Douglas,Blackburn Rovers,2000000,Wypożyczenie,GB2,2020,400000,-1600000
661053,Jarrad Branthwaite,Blackburn Rovers,2000000,Wypożyczenie,GB2,2020,7000000,5000000
62008,Stefan Johansen,Queens Park Rangers,2000000,Wypożyczenie,GB2,2020,1000000,-1000000
62008,Stefan Johansen,West Bromwich Albion,4000000,Wypożyczenie,GB2,2018,1000000,-3000000
541231,Sepp van den Berg,Preston North End,1000000,Wypożyczenie,GB2,2020,5000000,4000000
359210,Alfa Semedo,FC Reading,1000000,Wypożyczenie,GB2,2020,1000000,0
359210,Alfa Semedo,Nottingham Forest,2000000,Wypożyczenie,GB2,2019,1000000,-1000000
116648,Marcus Bettinelli,FC Middlesbrough,1000000,Wypożyczenie,GB2,2020,2000000,1000000
45693,Glenn Murray,FC Watford,1000000,Wypożyczenie,GB2,2020,0,-1000000
215096,Jordy de Wijs,Queens Park Rangers,1000000,Wypożyczenie,GB2,2020,1000000,0
228912,Liam Lindsay,Preston North End,1000000,Wypożyczenie,GB2,2020,1000000,0
37526,Winston Reid,FC Brentford,1000000,Wypożyczenie,GB2,2020,0,-1000000
399369,Beni Baningime,Derby County,1000000,Wypożyczenie,GB2,2020,850000,-150000
399369,Beni Baningime,Wigan Athletic,2000000,Wypożyczenie,GB2,2018,850000,-1150000
73522,Matty James,Coventry City,1000000,Wypożyczenie,GB2,2020,900000,-100000
73522,Matty James,FC Barnsley,1000000,Wypożyczenie,GB2,2020,900000,-100000
258216,Kasey Palmer,Swansea City,1000000,Wypożyczenie,GB2,2020,1000000,0
258216,Kasey Palmer,Blackburn Rovers,1000000,Wypożyczenie,GB2,2018,1000000,0
258216,Kasey Palmer,Bristol City,1000000,Wypożyczenie,GB2,2018,1000000,0
111422,Neeskens Kebano,FC Middlesbrough,1000000,Wypożyczenie,GB2,2020,3000000,2000000
124873,Florian Jozefzoon,Rotherham United,1000000,Wypożyczenie,GB2,2020,500000,-500000
203655,Cafú,Nottingham Forest,1000000,Wypożyczenie,GB2,2020,600000,-400000
387331,Sam Field,Queens Park Rangers,1000000,Wypożyczenie,GB2,2020,2000000,1000000
387331,Sam Field,Charlton Athletic,1000000,Wypożyczenie,GB2,2019,2000000,1000000
325443,Viktor Gyökeres,Coventry City,1000000,Wypożyczenie,GB2,2020,8000000,7000000
325443,Viktor Gyökeres,Swansea City,1000000,Wypożyczenie,GB2,2020,8000000,7000000
428061,Riley McGree,Birmingham City,900000,Wypożyczenie,GB2,2020,3000000,2100000
208428,Lee Gregory,Derby County,800000,Wypożyczenie,GB2,2020,250000,-550000
385848,George Edmundson,Derby County,500000,Wypożyczenie,GB2,2020,400000,-100000
543164,Rhys Norrington-Davies,Stoke City,500000,Wypożyczenie,GB2,2020,3000000,2500000
543164,Rhys Norrington-Davies,Luton Town,0,Wypożyczenie,GB2,2020,3000000,3000000
543164,Rhys Norrington-Davies,AFC Rochdale,0,Wypożyczenie,GB3,2019,3000000,3000000
192611,Joel Pereira,Huddersfield Town,475000,Wypożyczenie,GB2,2020,300000,-175000
128898,Jamal Blackman,Rotherham United,400000,Wypożyczenie,GB2,2020,400000,0
128898,Jamal Blackman,Bristol Rovers,500000,Wypożyczenie,GB3,2019,400000,-100000
128898,Jamal Blackman,Leeds United,250000,Wypożyczenie,GB2,2018,400000,150000
61622,Ched Evans,Preston North End,300000,Wypożyczenie,GB2,2020,250000,-50000
61622,Ched Evans,Fleetwood Town,350000,Wypożyczenie,GB3,2018,250000,-100000
611906,Nnamdi Ofoborh,Wycombe Wanderers,250000,Wypożyczenie,GB2,2020,400000,150000
611906,Nnamdi Ofoborh,Wycombe Wanderers,150000,Wypożyczenie,GB3,2019,400000,250000
353147,Dennis Adeniran,Wycombe Wanderers,0,Wypożyczenie,GB2,2020,500000,500000
475188,Kiernan Dewsbury-Hall,Luton Town,0,Wypożyczenie,GB2,2020,25000000,25000000
475188,Kiernan Dewsbury-Hall,FC Blackpool,0,Wypożyczenie,GB3,2019,25000000,25000000
425026,Josh Knight,Wycombe Wanderers,0,Wypożyczenie,GB2,2020,900000,900000
425026,Josh Knight,Peterborough United,0,Wypożyczenie,GB3,2019,900000,900000
425026,Josh Knight,Peterborough United,0,Wypożyczenie,GB3,2018,900000,900000
452380,Sam Nombe,Luton Town,0,Wypożyczenie,GB2,2020,500000,500000
314384,Ben Sheaf,Coventry City,0,Wypożyczenie,GB2,2020,3000000,3000000
314384,Ben Sheaf,Doncaster Rovers,0,Wypożyczenie,GB3,2019,3000000,3000000
344015,Ben Woodburn,FC Blackpool,4000000,Wypożyczenie,GB3,2020,1000000,-3000000
344015,Ben Woodburn,Oxford United,5000000,Wypożyczenie,GB3,2019,1000000,-4000000
344015,Ben Woodburn,Sheffield United,5000000,Wypożyczenie,GB2,2018,1000000,-4000000
491737,Josef Bursik,Peterborough United,2000000,Wypożyczenie,GB3,2020,2000000,0
491737,Josef Bursik,Lincoln City,2000000,Wypożyczenie,GB3,2020,2000000,0
491737,Josef Bursik,Doncaster Rovers,0,Wypożyczenie,GB3,2020,2000000,2000000
491737,Josef Bursik,Accrington Stanley,0,Wypożyczenie,GB3,2019,2000000,2000000
240083,George Byers,FC Portsmouth,1000000,Wypożyczenie,GB3,2020,450000,-550000
308632,Callum Connolly,Fleetwood Town,1000000,Wypożyczenie,GB3,2020,1000000,0
308632,Callum Connolly,Lincoln City,2000000,Wypożyczenie,GB3,2019,1000000,-1000000
308632,Callum Connolly,Fleetwood Town,2000000,Wypożyczenie,GB3,2019,1000000,-1000000
308632,Callum Connolly,Bolton Wanderers,2000000,Wypożyczenie,GB2,2018,1000000,-1000000
308632,Callum Connolly,Wigan Athletic,1000000,Wypożyczenie,GB2,2018,1000000,0
286919,Josh Sims,Doncaster Rovers,1000000,Wypożyczenie,GB3,2020,400000,-600000
286919,Josh Sims,FC Reading,750000,Wypożyczenie,GB2,2018,400000,-350000
223225,Dan Crowley,Hull City,1000000,Wypożyczenie,GB3,2020,450000,-550000
321096,Keanan Bennetts,Ipswich Town,1000000,Wypożyczenie,GB3,2020,600000,-400000
134293,Jayden Stockley,Charlton Athletic,900000,Wypożyczenie,GB3,2020,900000,0
220755,Matthew Pennington,Shrewsbury Town,800000,Wypożyczenie,GB3,2020,500000,-300000
220755,Matthew Pennington,Hull City,1000000,Wypożyczenie,GB2,2019,500000,-500000
220755,Matthew Pennington,Ipswich Town,500000,Wypożyczenie,GB2,2018,500000,0
487924,Jan Zamburek,Shrewsbury Town,800000,Wypożyczenie,GB3,2020,500000,-300000
208934,Barrie McKay,Fleetwood Town,800000,Wypożyczenie,GB3,2020,850000,50000
208934,Barrie McKay,Fleetwood Town,1000000,Wypożyczenie,GB3,2019,850000,-150000
496652,Dylan Levitt,Charlton Athletic,675000,Wypożyczenie,GB3,2020,800000,125000
249256,Jordan Jones,AFC Sunderland,600000,Wypożyczenie,GB3,2020,500000,-100000
283227,Rasmus Nicolaisen,FC Portsmouth,600000,Wypożyczenie,GB3,2020,5000000,4400000
357658,Mark Travers,Swindon Town,500000,Wypożyczenie,GB3,2020,2000000,1500000
214927,Brandon Barker,Oxford United,500000,Wypożyczenie,GB3,2020,350000,-150000
214927,Brandon Barker,Preston North End,400000,Wypożyczenie,GB2,2018,350000,-50000
426281,Josh Earl,Burton Albion,450000,Wypożyczenie,GB3,2020,900000,450000
426281,Josh Earl,Bolton Wanderers,500000,Wypożyczenie,GB3,2019,900000,400000
426281,Josh Earl,Ipswich Town,500000,Wypożyczenie,GB3,2019,900000,400000
36866,Billy Jones,Crewe Alexandra,400000,Wypożyczenie,GB3,2020,0,-400000
402770,Matthew Millar,Shrewsbury Town,400000,Wypożyczenie,GB3,2020,400000,0
326843,Erhun Öztümer,Bristol Rovers,400000,Wypożyczenie,GB3,2020,300000,-100000
51733,Andrew Shinnie,Charlton Athletic,400000,Wypożyczenie,GB3,2020,375000,-25000
60951,Funso Ojo,Wigan Athletic,400000,Wypożyczenie,GB3,2020,350000,-50000
197791,Janoi Donacien,Fleetwood Town,400000,Wypożyczenie,GB3,2020,300000,-100000
197791,Janoi Donacien,Ipswich Town,250000,Wypożyczenie,GB2,2018,300000,50000
197791,Janoi Donacien,Accrington Stanley,750000,Wypożyczenie,GB3,2018,300000,-450000
87658,Olly Lee,FC Gillingham,350000,Wypożyczenie,GB3,2020,0,-350000
87658,Olly Lee,FC Gillingham,450000,Wypożyczenie,GB3,2019,0,-450000
425456,Sean Clare,Burton Albion,350000,Wypożyczenie,GB3,2020,400000,50000
374283,Antony Evans,Crewe Alexandra,350000,Wypożyczenie,GB3,2020,450000,100000
374283,Antony Evans,FC Blackpool,0,Wypożyczenie,GB3,2018,450000,450000
563694,Mickel Miller,Northampton Town,300000,Wypożyczenie,GB3,2020,300000,0
503990,Nathan Wood,Crewe Alexandra,300000,Wypożyczenie,GB3,2020,1000000,700000
205757,Dejan Iliev,Shrewsbury Town,300000,Wypożyczenie,GB3,2020,300000,0
128262,Scott Wootton,Wigan Athletic,300000,Wypożyczenie,GB3,2020,300000,0
293002,Kyle Vassell,Fleetwood Town,300000,Wypożyczenie,GB3,2020,350000,50000
340320,Marcus McGuane,Oxford United,300000,Wypożyczenie,GB3,2020,300000,0
345587,Luka Racic,Northampton Town,300000,Wypożyczenie,GB3,2020,250000,-50000
646900,Elliot Simoes,Doncaster Rovers,250000,Wypożyczenie,GB3,2020,175000,-75000
205326,Jonathan Mitchell,Northampton Town,250000,Wypożyczenie,GB3,2020,200000,-50000
205326,Jonathan Mitchell,Macclesfield Town FC,250000,Wypożyczenie,GB4,2019,200000,-50000
205326,Jonathan Mitchell,Shrewsbury Town,150000,Wypożyczenie,GB3,2018,200000,50000
205326,Jonathan Mitchell,Oxford United,150000,Wypożyczenie,GB3,2018,200000,50000
207771,Louis Thompson,Milton Keynes Dons,250000,Wypożyczenie,GB3,2020,200000,-50000
207771,Louis Thompson,Shrewsbury Town,250000,Wypożyczenie,GB3,2019,200000,-50000
207771,Louis Thompson,Milton Keynes Dons,250000,Wypożyczenie,GB3,2019,200000,-50000
277069,Joe Nuttall,Northampton Town,250000,Wypożyczenie,GB3,2020,0,-250000
469860,Indiana Vassilev,Burton Albion,250000,Wypożyczenie,GB3,2020,1000000,750000
469860,Indiana Vassilev,Cheltenham Town,250000,Wypożyczenie,GB4,2020,1000000,750000
421424,Jake Vokins,AFC Sunderland,250000,Wypożyczenie,GB3,2020,0,-250000
104564,Joe Day,Bristol Rovers,250000,Wypożyczenie,GB3,2020,175000,-75000
104564,Joe Day,AFC Wimbledon,250000,Wypożyczenie,GB3,2019,175000,-75000
408872,Paul Smyth,Charlton Athletic,250000,Wypożyczenie,GB3,2020,300000,50000
408872,Paul Smyth,Accrington Stanley,250000,Wypożyczenie,GB3,2020,300000,50000
408872,Paul Smyth,Wycombe Wanderers,250000,Wypożyczenie,GB3,2019,300000,50000
408872,Paul Smyth,Accrington Stanley,250000,Wypożyczenie,GB3,2018,300000,50000
318549,George Johnston,Wigan Athletic,250000,Wypożyczenie,GB3,2020,800000,550000
534698,Robbie Gotts,Lincoln City,250000,Wypożyczenie,GB3,2020,200000,-50000
534698,Robbie Gotts,Salford City,250000,Wypożyczenie,GB4,2020,200000,-50000
433893,Jaakko Oksanen,AFC Wimbledon,250000,Wypożyczenie,GB3,2020,300000,50000
37428,Charlie Mulgrew,Fleetwood Town,250000,Wypożyczenie,GB3,2020,300000,50000
37428,Charlie Mulgrew,Wigan Athletic,1000000,Wypożyczenie,GB2,2019,300000,-700000
325105,Tom James,Wigan Athletic,200000,Wypożyczenie,GB3,2020,200000,0
325105,Tom James,Salford City,200000,Wypożyczenie,GB4,2020,200000,0
418144,Joe Wollacott,Swindon Town,200000,Wypożyczenie,GB3,2020,300000,100000
418144,Joe Wollacott,Forest Green Rovers,100000,Wypożyczenie,GB4,2019,300000,200000
533913,Jordan Stevens,Swindon Town,200000,Wypożyczenie,GB3,2020,0,-200000
533913,Jordan Stevens,Bradford City,200000,Wypożyczenie,GB4,2020,0,-200000
246963,Carlton Morris,Milton Keynes Dons,150000,Wypożyczenie,GB3,2020,2000000,1850000
246963,Carlton Morris,Rotherham United,150000,Wypożyczenie,GB3,2019,2000000,1850000
246963,Carlton Morris,Milton Keynes Dons,150000,Wypożyczenie,GB3,2019,2000000,1850000
129558,Sam Walker,AFC Wimbledon,150000,Wypożyczenie,GB3,2020,400000,250000
129558,Sam Walker,FC Blackpool,150000,Wypożyczenie,GB3,2020,400000,250000
128420,Jamie Proctor,Wigan Athletic,150000,Wypożyczenie,GB3,2020,200000,50000
128420,Jamie Proctor,Newport County,150000,Wypożyczenie,GB4,2020,200000,50000
128420,Jamie Proctor,Scunthorpe United,175000,Wypożyczenie,GB4,2019,200000,25000
618903,Josh Eccles,FC Gillingham,100000,Wypożyczenie,GB3,2020,300000,200000
364409,Gabriel Osho,AFC Rochdale,100000,Wypożyczenie,GB3,2020,400000,300000
364409,Gabriel Osho,Bristol Rovers,0,Wypożyczenie,GB3,2018,400000,400000
611650,Sam Woods,Plymouth Argyle,75000,Wypożyczenie,GB3,2020,0,-75000
259151,Dillon Barnes,Burton Albion,50000,Wypożyczenie,GB3,2020,150000,100000
332342,Callum Slattery,FC Gillingham,50000,Wypożyczenie,GB3,2020,450000,400000
292734,George Dobson,AFC Wimbledon,0,Wypożyczenie,GB3,2020,400000,400000
236870,Matt Palmer,Wigan Athletic,0,Wypożyczenie,GB3,2020,0,0
236870,Matt Palmer,Bradford City,250000,Wypożyczenie,GB4,2019,0,-250000
252986,Liam Kelly,Oxford United,0,Wypożyczenie,GB3,2020,250000,250000
252986,Liam Kelly,Oxford United,600000,Wypożyczenie,GB3,2019,250000,-350000
249063,Ryan Hardie,Plymouth Argyle,0,Wypożyczenie,GB3,2020,600000,600000
249063,Ryan Hardie,Plymouth Argyle,0,Wypożyczenie,GB4,2019,600000,600000
731466,Teddy Sharman-Lowe,Burton Albion,0,Wypożyczenie,GB3,2020,0,0
408563,Jerome Opoku,Plymouth Argyle,0,Wypożyczenie,GB3,2020,700000,700000
408563,Jerome Opoku,Accrington Stanley,0,Wypożyczenie,GB3,2019,700000,700000
406559,Timothy Eyoma,Lincoln City,0,Wypożyczenie,GB3,2020,500000,500000
406559,Timothy Eyoma,Lincoln City,0,Wypożyczenie,GB3,2019,500000,500000
496660,Jack Vale,AFC Rochdale,0,Wypożyczenie,GB3,2020,500000,500000
379711,Robbie Cundy,FC Gillingham,0,Wypożyczenie,GB3,2020,300000,300000
379711,Robbie Cundy,Cambridge United,0,Wypożyczenie,GB4,2020,300000,300000
379711,Robbie Cundy,Exeter City,0,Wypożyczenie,GB4,2019,300000,300000
504943,Declan Drysdale,FC Gillingham,0,Wypożyczenie,GB3,2020,125000,125000
504943,Declan Drysdale,Cambridge United,0,Wypożyczenie,GB4,2020,125000,125000
554250,Morgan Boyes,Fleetwood Town,0,Wypożyczenie,GB3,2020,250000,250000
258910,Lewis Ward,FC Portsmouth,0,Wypożyczenie,GB3,2020,0,0
258910,Lewis Ward,Forest Green Rovers,0,Wypożyczenie,GB4,2018,0,0
258910,Lewis Ward,Northampton Town,0,Wypożyczenie,GB4,2018,0,0
473080,Regan Slater,Hull City,0,Wypożyczenie,GB3,2020,2000000,2000000
473080,Regan Slater,Scunthorpe United,0,Wypożyczenie,GB4,2019,2000000,2000000
473080,Regan Slater,Carlisle United,0,Wypożyczenie,GB4,2018,2000000,2000000
562396,Ryan Cassidy,Accrington Stanley,0,Wypożyczenie,GB3,2020,0,0
425900,Jordan Lawrence-Gabriel,FC Blackpool,0,Wypożyczenie,GB3,2020,1000000,1000000
425900,Jordan Lawrence-Gabriel,Scunthorpe United,0,Wypożyczenie,GB4,2019,1000000,1000000
433254,Trae Coyle,FC Gillingham,0,Wypożyczenie,GB3,2020,400000,400000
547382,Cameron Pring,FC Portsmouth,0,Wypożyczenie,GB3,2020,400000,400000
547382,Cameron Pring,FC Walsall,0,Wypożyczenie,GB4,2019,400000,400000
547382,Cameron Pring,Cheltenham Town,0,Wypożyczenie,GB4,2018,400000,400000
547382,Cameron Pring,Newport County,0,Wypożyczenie,GB4,2018,400000,400000
357967,Lasse Sörensen,Milton Keynes Dons,0,Wypożyczenie,GB3,2020,450000,450000
396854,Tariq Uwakwe,Accrington Stanley,0,Wypożyczenie,GB3,2020,250000,250000
417256,Shilow Tracey,Shrewsbury Town,0,Wypożyczenie,GB3,2020,250000,250000
417256,Shilow Tracey,Cambridge United,0,Wypożyczenie,GB4,2020,250000,250000
417256,Shilow Tracey,Macclesfield Town FC,0,Wypożyczenie,GB4,2019,250000,250000
426412,Harry Pickering,Crewe Alexandra,0,Wypożyczenie,GB3,2020,3000000,3000000
449020,Warren O'Hora,Milton Keynes Dons,0,Wypożyczenie,GB3,2020,600000,600000
404586,Tyreke Johnson,FC Gillingham,0,Wypożyczenie,GB3,2020,0,0
314372,Darnell Johnson,Wigan Athletic,0,Wypożyczenie,GB3,2020,150000,150000
314372,Darnell Johnson,AFC Wimbledon,0,Wypożyczenie,GB3,2020,150000,150000
484390,Tom Allan,Accrington Stanley,0,Wypożyczenie,GB3,2020,0,0
475455,Jayden Mitchell-Lawson,Bristol Rovers,0,Wypożyczenie,GB3,2020,150000,150000
475455,Jayden Mitchell-Lawson,Bristol Rovers,0,Wypożyczenie,GB3,2019,150000,150000
369171,Niall Ennis,Burton Albion,0,Wypożyczenie,GB3,2020,400000,400000
369171,Niall Ennis,Doncaster Rovers,0,Wypożyczenie,GB3,2019,400000,400000
505561,Jon Russell,Accrington Stanley,0,Wypożyczenie,GB3,2020,600000,600000
682035,James Morton,FC Gillingham,0,Wypożyczenie,GB3,2020,0,0
682035,James Morton,Grimsby Town,0,Wypożyczenie,GB4,2020,0,0
682035,James Morton,Forest Green Rovers,0,Wypożyczenie,GB4,2019,0,0
487417,Liam Millar,Charlton Athletic,0,Wypożyczenie,GB3,2020,1000000,1000000
470607,Brennan Johnson,Lincoln City,0,Wypożyczenie,GB3,2020,30000000,30000000
505198,Mo Sangare,Accrington Stanley,0,Wypożyczenie,GB3,2020,200000,200000
396858,Luke McCormick,Bristol Rovers,0,Wypożyczenie,GB3,2020,200000,200000
396858,Luke McCormick,Shrewsbury Town,0,Wypożyczenie,GB3,2019,200000,200000
357661,Thomas O'Connor,FC Gillingham,0,Wypożyczenie,GB3,2020,0,0
357661,Thomas O'Connor,FC Gillingham,0,Wypożyczenie,GB3,2019,0,0
424414,Jonny Smith,Swindon Town,0,Wypożyczenie,GB3,2020,300000,300000
424414,Jonny Smith,Oldham Athletic,0,Wypożyczenie,GB4,2019,300000,300000
424414,Jonny Smith,Tranmere Rovers,0,Wypożyczenie,GB4,2018,300000,300000
364828,Elliot Embleton,FC Blackpool,0,Wypożyczenie,GB3,2020,1000000,1000000
364828,Elliot Embleton,Grimsby Town,0,Wypożyczenie,GB4,2018,1000000,1000000
382550,Joe Hilton,Fleetwood Town,0,Wypożyczenie,GB3,2020,150000,150000
431425,Jack Roles,Burton Albion,0,Wypożyczenie,GB3,2020,100000,100000
431425,Jack Roles,FC Stevenage,0,Wypożyczenie,GB4,2020,100000,100000
431425,Jack Roles,Cambridge United,0,Wypożyczenie,GB4,2019,100000,100000
392761,Zechariah Medley,FC Gillingham,0,Wypożyczenie,GB3,2020,500000,500000
357397,Kazaiah Sterling,Southend United,1000000,Wypożyczenie,GB4,2020,300000,-700000
357397,Kazaiah Sterling,Doncaster Rovers,2000000,Wypożyczenie,GB3,2019,300000,-1700000
357397,Kazaiah Sterling,Leyton Orient,2000000,Wypożyczenie,GB4,2019,300000,-1700000
357397,Kazaiah Sterling,AFC Sunderland,0,Wypożyczenie,GB3,2018,300000,300000
70273,Liam Feeney,Tranmere Rovers,600000,Wypożyczenie,GB4,2020,0,-600000
43266,Stephen Quinn,Mansfield Town,600000,Wypożyczenie,GB4,2020,150000,-450000
79620,Ali Crawford,Tranmere Rovers,550000,Wypożyczenie,GB4,2020,375000,-175000
244125,Hiram Boateng,Cambridge United,400000,Wypożyczenie,GB4,2020,200000,-200000
238585,Declan John,Bolton Wanderers,400000,Wypożyczenie,GB4,2020,450000,50000
238585,Declan John,AFC Sunderland,800000,Wypożyczenie,GB3,2019,450000,-350000
33963,David Nugent,Tranmere Rovers,300000,Wypożyczenie,GB4,2020,0,-300000
153634,Marcel Hilßner,Oldham Athletic,300000,Wypożyczenie,GB4,2020,200000,-100000
67339,David Stockdale,FC Stevenage,300000,Wypożyczenie,GB4,2020,150000,-150000
67339,David Stockdale,Wycombe Wanderers,500000,Wypożyczenie,GB3,2019,150000,-350000
67339,David Stockdale,Southend United,2000000,Wypożyczenie,GB3,2018,150000,-1850000
67339,David Stockdale,Wycombe Wanderers,1000000,Wypożyczenie,GB3,2018,150000,-850000
67339,David Stockdale,Coventry City,1000000,Wypożyczenie,GB3,2018,150000,-850000
39705,Nicky Maynard,Newport County,300000,Wypożyczenie,GB4,2020,0,-300000
471243,Derick Osei,FC Walsall,250000,Wypożyczenie,GB4,2020,250000,0
334816,Brad Lyons,FC Morecambe,250000,Wypożyczenie,GB4,2020,200000,-50000
334816,Brad Lyons,Blackburn Rovers,0,Wypożyczenie,GB2,2018,200000,200000
315185,Jake Hesketh,Crawley Town,200000,Wypożyczenie,GB4,2020,0,-200000
315185,Jake Hesketh,Lincoln City,200000,Wypożyczenie,GB3,2019,0,-200000
315185,Jake Hesketh,Burton Albion,0,Wypożyczenie,GB3,2018,0,0
315185,Jake Hesketh,Milton Keynes Dons,0,Wypożyczenie,GB4,2018,0,0
225121,Luke Gambin,Newport County,200000,Wypożyczenie,GB4,2020,175000,-25000
225121,Luke Gambin,Crawley Town,200000,Wypożyczenie,GB4,2018,175000,-25000
382552,Mace Goodridge,AFC Barrow,200000,Wypożyczenie,GB4,2020,0,-200000
448813,Nick Freeman,Leyton Orient,200000,Wypożyczenie,GB4,2020,200000,0
157075,Ben Coker,FC Stevenage,150000,Wypożyczenie,GB4,2020,0,-150000
157075,Ben Coker,Cambridge United,150000,Wypożyczenie,GB4,2019,0,-150000
316776,Tom Davies,AFC Barrow,150000,Wypożyczenie,GB4,2020,125000,-25000
85662,Jamie Devitt,Newport County,150000,Wypożyczenie,GB4,2020,100000,-50000
85662,Jamie Devitt,Bradford City,150000,Wypożyczenie,GB4,2019,100000,-50000
49428,Neal Eardley,AFC Barrow,150000,Wypożyczenie,GB4,2020,0,-150000
476149,George Lapslie,Mansfield Town,150000,Wypożyczenie,GB4,2020,200000,50000
346485,Odin Bailey,Forest Green Rovers,150000,Wypożyczenie,GB4,2020,250000,100000
346485,Odin Bailey,Forest Green Rovers,150000,Wypożyczenie,GB4,2019,250000,100000
424902,Teddy Howe,Scunthorpe United,150000,Wypożyczenie,GB4,2020,0,-150000
562254,Kyle Taylor,Southend United,100000,Wypożyczenie,GB4,2020,200000,100000
562254,Kyle Taylor,Forest Green Rovers,0,Wypożyczenie,GB4,2019,200000,200000
183166,Ian Lawlor,Oldham Athletic,100000,Wypożyczenie,GB4,2020,100000,0
183166,Ian Lawlor,Scunthorpe United,100000,Wypożyczenie,GB4,2019,100000,0
462113,Aramide Oteh,FC Stevenage,100000,Wypożyczenie,GB4,2020,125000,25000
462113,Aramide Oteh,Colchester United,100000,Wypożyczenie,GB4,2020,125000,25000
462113,Aramide Oteh,Bradford City,100000,Wypożyczenie,GB4,2019,125000,25000
462113,Aramide Oteh,FC Walsall,100000,Wypożyczenie,GB3,2018,125000,25000
424885,Sam Smith,Cheltenham Town,100000,Wypożyczenie,GB4,2020,500000,400000
424885,Sam Smith,Tranmere Rovers,100000,Wypożyczenie,GB4,2020,500000,400000
424885,Sam Smith,Cambridge United,100000,Wypożyczenie,GB4,2019,500000,400000
424885,Sam Smith,Oxford United,100000,Wypożyczenie,GB3,2018,500000,400000
424885,Sam Smith,Shrewsbury Town,100000,Wypożyczenie,GB3,2018,500000,400000
416622,Jordan Green,Southend United,100000,Wypożyczenie,GB4,2020,125000,25000
416622,Jordan Green,Newport County,100000,Wypożyczenie,GB4,2019,125000,25000
293258,Oliver Sarkic,Mansfield Town,100000,Wypożyczenie,GB4,2020,200000,100000
396176,Tom Sang,Cheltenham Town,100000,Wypożyczenie,GB4,2020,300000,200000
491741,Anthony Hartigan,Newport County,50000,Wypożyczenie,GB4,2020,175000,125000
485998,Connor Malley,Carlisle United,50000,Wypożyczenie,GB4,2020,50000,0
167259,Josh Doherty,Colchester United,50000,Wypożyczenie,GB4,2020,0,-50000
293779,Zack Elbouzedi,Bolton Wanderers,50000,Wypożyczenie,GB4,2020,300000,250000
281891,Dan Jones,Harrogate Town,0,Wypożyczenie,GB4,2020,200000,200000
221561,Marcus Maddison,Bolton Wanderers,0,Wypożyczenie,GB4,2020,0,0
221561,Marcus Maddison,Hull City,750000,Wypożyczenie,GB2,2019,0,-750000
67359,Bobby Grant,Oldham Athletic,0,Wypożyczenie,GB4,2020,0,0
67359,Bobby Grant,Accrington Stanley,0,Wypożyczenie,GB3,2019,0,0
131593,Kyle Bennett,Grimsby Town,0,Wypożyczenie,GB4,2020,0,0
131593,Kyle Bennett,Swindon Town,0,Wypożyczenie,GB4,2018,0,0
177613,George Taft,Scunthorpe United,0,Wypożyczenie,GB4,2020,0,0
628220,Virgil Gomis,Grimsby Town,0,Wypożyczenie,GB4,2020,0,0
628220,Virgil Gomis,Macclesfield Town FC,0,Wypożyczenie,GB4,2019,0,0
628220,Virgil Gomis,Notts County,0,Wypożyczenie,GB4,2018,0,0
133397,Andy Cook,Bradford City,0,Wypożyczenie,GB4,2020,250000,250000
133397,Andy Cook,Tranmere Rovers,0,Wypożyczenie,GB3,2019,250000,250000
93055,Paul Coutts,Salford City,0,Wypożyczenie,GB4,2020,100000,100000
529746,Bryce Hosannah,Bradford City,0,Wypożyczenie,GB4,2020,0,0
624946,Rumarn Burrell,Bradford City,0,Wypożyczenie,GB4,2020,0,0
702715,Jake Taylor,Scunthorpe United,0,Wypożyczenie,GB4,2020,200000,200000
702715,Jake Taylor,Port Vale FC,0,Wypożyczenie,GB4,2019,200000,200000
314371,Jahmal Hector-Ingram,FC Stevenage,0,Wypożyczenie,GB4,2020,0,0
465950,Alex Denny,FC Morecambe,0,Wypożyczenie,GB4,2020,50000,50000
620168,Tyler Cordner,Scunthorpe United,0,Wypożyczenie,GB4,2020,0,0
620168,Tyler Cordner,Southend United,0,Wypożyczenie,GB4,2020,0,0
347212,Tunji Akinola,Leyton Orient,0,Wypożyczenie,GB4,2020,175000,175000
344014,Aaron Lewis,Newport County,0,Wypożyczenie,GB4,2020,175000,175000
344014,Aaron Lewis,Doncaster Rovers,0,Wypożyczenie,GB3,2018,175000,175000
586059,William Hondermarck,Harrogate Town,0,Wypożyczenie,GB4,2020,175000,175000
533958,Harrison Biggins,AFC Barrow,0,Wypożyczenie,GB4,2020,300000,300000
741948,Ben Garrity,Oldham Athletic,0,Wypożyczenie,GB4,2020,300000,300000
346474,Martell Taylor-Crossdale,Colchester United,0,Wypożyczenie,GB4,2020,0,0
502065,Aji Alese,Cambridge United,0,Wypożyczenie,GB4,2020,1000000,1000000
502065,Aji Alese,Accrington Stanley,0,Wypożyczenie,GB3,2019,1000000,1000000
459843,Reeco Hackett,Southend United,0,Wypożyczenie,GB4,2020,250000,250000
423669,Dan Bramall,AFC Barrow,0,Wypożyczenie,GB4,2020,0,0
640893,Ethan Walker,Carlisle United,0,Wypożyczenie,GB4,2020,200000,200000
487850,Oladapo Afolayan,Bolton Wanderers,0,Wypożyczenie,GB4,2020,800000,800000
487850,Oladapo Afolayan,Mansfield Town,0,Wypożyczenie,GB4,2019,800000,800000
487850,Oladapo Afolayan,Oldham Athletic,0,Wypożyczenie,GB4,2018,800000,800000
390693,Mitchell Clark,Port Vale FC,0,Wypożyczenie,GB4,2020,250000,250000
390693,Mitchell Clark,Port Vale FC,0,Wypożyczenie,GB4,2019,250000,250000
390693,Mitchell Clark,Port Vale FC,0,Wypożyczenie,GB4,2018,250000,250000
559254,Jayden Reid,AFC Barrow,0,Wypożyczenie,GB4,2020,100000,100000
559254,Jayden Reid,FC Walsall,0,Wypożyczenie,GB4,2020,100000,100000
433818,Scott Twine,Newport County,0,Wypożyczenie,GB4,2020,2000000,2000000
731754,Mustapha Olagunju,Port Vale FC,0,Wypożyczenie,GB4,2020,0,0
411504,Calum MacDonald,Tranmere Rovers,0,Wypożyczenie,GB4,2020,100000,100000
691064,Remeao Hutton,FC Stevenage,0,Wypożyczenie,GB4,2020,200000,200000
804473,Bradley Webb,Newport County,0,Wypożyczenie,GB4,2020,0,0
795638,Micah Obiero,Carlisle United,0,Wypożyczenie,GB4,2020,0,0
244225,James Montgomery,Southend United,0,Wypożyczenie,GB4,2020,0,0
514370,Jubril Okedina,Cambridge United,0,Wypożyczenie,GB4,2020,500000,500000
610898,Jamie Pardington,Mansfield Town,0,Wypożyczenie,GB4,2020,0,0
478014,Ryan Cooney,FC Morecambe,0,Wypożyczenie,GB4,2020,250000,250000
478014,Ryan Cooney,FC Morecambe,0,Wypożyczenie,GB4,2019,250000,250000
563306,Jordan Thomas,Leyton Orient,0,Wypożyczenie,GB4,2020,0,0
341028,Jordan Maguire-Drew,Crawley Town,0,Wypożyczenie,GB4,2020,0,0
633129,George Nurse,FC Walsall,0,Wypożyczenie,GB4,2020,250000,250000
633129,George Nurse,Newport County,0,Wypożyczenie,GB4,2019,250000,250000
565676,Danny Preston,Grimsby Town,0,Wypożyczenie,GB4,2020,0,0
406633,Nya Kirby,Tranmere Rovers,0,Wypożyczenie,GB4,2020,300000,300000
406633,Nya Kirby,FC Blackpool,0,Wypożyczenie,GB3,2018,300000,300000
536794,Billy Crellin,Bolton Wanderers,0,Wypożyczenie,GB4,2020,0,0
547045,Joe Adams,Grimsby Town,0,Wypożyczenie,GB4,2020,100000,100000
392762,Austin Samuels,Bradford City,0,Wypożyczenie,GB4,2020,175000,175000
568092,Elliot Bonds,Cheltenham Town,0,Wypożyczenie,GB4,2020,250000,250000
566348,Marcus Dewhurst,Carlisle United,0,Wypożyczenie,GB4,2020,0,0
566348,Marcus Dewhurst,Carlisle United,0,Wypożyczenie,GB4,2019,0,0
716109,Adan George,FC Walsall,0,Wypożyczenie,GB4,2020,100000,100000
735677,Josh March,Harrogate Town,0,Wypożyczenie,GB4,2020,125000,125000
496786,Tom White,Bolton Wanderers,0,Wypożyczenie,GB4,2020,200000,200000
690884,Frank Vincent,FC Walsall,0,Wypożyczenie,GB4,2020,0,0
690884,Frank Vincent,Scunthorpe United,0,Wypożyczenie,GB4,2020,0,0
463758,Terry Taylor,Grimsby Town,0,Wypożyczenie,GB4,2020,300000,300000
458187,Arthur Read,FC Stevenage,0,Wypożyczenie,GB4,2020,125000,125000
565675,Jayden Richardson,Forest Green Rovers,0,Wypożyczenie,GB4,2020,400000,400000
565675,Jayden Richardson,Exeter City,0,Wypożyczenie,GB4,2019,400000,400000
526862,Serhat Tasdemir,Oldham Athletic,0,Wypożyczenie,GB4,2020,0,0
506965,James Olayinka,Southend United,0,Wypożyczenie,GB4,2020,200000,200000
506965,James Olayinka,Northampton Town,0,Wypożyczenie,GB4,2019,200000,200000
406556,Tom McGill,Crawley Town,0,Wypożyczenie,GB4,2020,200000,200000
406556,Tom McGill,Crawley Town,0,Wypożyczenie,GB4,2019,200000,200000
173900,Hélder Costa,Leeds United,15000000,Wypożyczenie,GB2,2019,3000000,-12000000
264956,Jean-Kévin Augustin,Leeds United,14000000,Wypożyczenie,GB2,2019,1000000,-13000000
152651,Terence Kongolo,FC Fulham,12000000,Wypożyczenie,GB2,2019,900000,-11100000
186186,Bobby De Cordova-Reid,FC Fulham,10000000,Wypożyczenie,GB2,2019,7000000,-3000000
340324,Eddie Nketiah,Leeds United,8000000,Wypożyczenie,GB2,2019,25000000,17000000
453594,Adama Diakhaby,Nottingham Forest,8000000,Wypożyczenie,GB2,2019,800000,-7200000
183299,Callum Robinson,West Bromwich Albion,7000000,Wypożyczenie,GB2,2019,3000000,-4000000
199527,Jacob Murphy,Sheffield Wednesday,6000000,Wypożyczenie,GB2,2019,10000000,4000000
232897,Ryan Woods,FC Millwall,5000000,Wypożyczenie,GB2,2019,2000000,-3000000
232897,Ryan Woods,Stoke City,2000000,Wypożyczenie,GB2,2018,2000000,0
542586,Illan Meslier,Leeds United,5000000,Wypożyczenie,GB2,2019,22000000,17000000
342048,Grady Diangana,West Bromwich Albion,5000000,Wypożyczenie,GB2,2019,6000000,1000000
122011,Markus Henriksen,Bristol City,5000000,Wypożyczenie,GB2,2019,1000000,-4000000
48870,Jonas Lössl,Huddersfield Town,5000000,Wypożyczenie,GB2,2019,600000,-4400000
73482,James Chester,Stoke City,4000000,Wypożyczenie,GB2,2019,250000,-3750000
99189,Pelé,FC Reading,4000000,Wypożyczenie,GB2,2019,800000,-3200000
99189,Pelé,Nottingham Forest,6000000,Wypożyczenie,GB2,2018,800000,-5200000
406560,Rhian Brewster,Swansea City,4000000,Wypożyczenie,GB2,2019,5000000,1000000
272636,Harold Moukoudi,FC Middlesbrough,4000000,Wypożyczenie,GB2,2019,4000000,0
173483,Nahki Wells,Queens Park Rangers,4000000,Wypożyczenie,GB2,2019,1000000,-3000000
173483,Nahki Wells,Queens Park Rangers,4000000,Wypożyczenie,GB2,2018,1000000,-3000000
83430,Albert Adomah,Cardiff City,3000000,Wypożyczenie,GB2,2019,250000,-2750000
258878,Tosin Adarabioyo,Blackburn Rovers,3000000,Wypożyczenie,GB2,2019,15000000,12000000
258878,Tosin Adarabioyo,West Bromwich Albion,1000000,Wypożyczenie,GB2,2018,15000000,14000000
258916,Kieran Dowell,Wigan Athletic,3000000,Wypożyczenie,GB2,2019,2000000,-1000000
258916,Kieran Dowell,Derby County,3000000,Wypożyczenie,GB2,2019,2000000,-1000000
258916,Kieran Dowell,Sheffield United,3000000,Wypożyczenie,GB2,2018,2000000,-1000000
138783,Scott Hogan,Birmingham City,3000000,Wypożyczenie,GB2,2019,2000000,-1000000
138783,Scott Hogan,Stoke City,3000000,Wypożyczenie,GB2,2019,2000000,-1000000
138783,Scott Hogan,Sheffield United,5000000,Wypożyczenie,GB2,2018,2000000,-3000000
114093,Greg Cunningham,Blackburn Rovers,3000000,Wypożyczenie,GB2,2019,350000,-2650000
361254,Rafa Mir,Nottingham Forest,3000000,Wypożyczenie,GB2,2019,10000000,7000000
346314,Trevoh Chalobah,Huddersfield Town,3000000,Wypożyczenie,GB2,2019,22000000,19000000
346314,Trevoh Chalobah,Ipswich Town,0,Wypożyczenie,GB2,2018,22000000,22000000
245893,Matt Miazga,FC Reading,3000000,Wypożyczenie,GB2,2019,2000000,-1000000
245893,Matt Miazga,FC Reading,3000000,Wypożyczenie,GB2,2018,2000000,-1000000
392765,Emile Smith Rowe,Huddersfield Town,3000000,Wypożyczenie,GB2,2019,38000000,35000000
21333,Aiden McGeady,Charlton Athletic,2000000,Wypożyczenie,GB2,2019,300000,-1700000
95435,Connor Wickham,Sheffield Wednesday,2000000,Wypożyczenie,GB2,2019,800000,-1200000
56872,Andy King,Huddersfield Town,2000000,Wypożyczenie,GB2,2019,300000,-1700000
56872,Andy King,Derby County,3000000,Wypożyczenie,GB2,2018,300000,-2700000
337670,Alessio Da Cruz,Sheffield Wednesday,2000000,Wypożyczenie,GB2,2019,1000000,-1000000
371021,Arijanet Muric,Nottingham Forest,2000000,Wypożyczenie,GB2,2019,6000000,4000000
309180,Jan Mlakar,Queens Park Rangers,2000000,Wypożyczenie,GB2,2019,2000000,0
309180,Jan Mlakar,Wigan Athletic,2000000,Wypożyczenie,GB2,2019,2000000,0
272539,David Bates,Sheffield Wednesday,2000000,Wypożyczenie,GB2,2019,650000,-1350000
226973,Harrison Reed,FC Fulham,2000000,Wypożyczenie,GB2,2019,15000000,13000000
226973,Harrison Reed,Blackburn Rovers,1000000,Wypożyczenie,GB2,2018,15000000,14000000
488362,Conor Gallagher,Swansea City,2000000,Wypożyczenie,GB2,2019,32000000,30000000
488362,Conor Gallagher,Charlton Athletic,0,Wypożyczenie,GB2,2019,32000000,32000000
309841,Andre Green,Charlton Athletic,2000000,Wypożyczenie,GB2,2019,750000,-1250000
309841,Andre Green,Preston North End,2000000,Wypożyczenie,GB2,2019,750000,-1250000
309841,Andre Green,FC Portsmouth,1000000,Wypożyczenie,GB3,2018,750000,-250000
314965,Pedro Pereira,Bristol City,2000000,Wypożyczenie,GB2,2019,2000000,0
156886,Jamie Paterson,Derby County,2000000,Wypożyczenie,GB2,2019,900000,-1100000
280813,Josh Windass,Sheffield Wednesday,2000000,Wypożyczenie,GB2,2019,600000,-1400000
334222,Lucas Boyé,FC Reading,1000000,Wypożyczenie,GB2,2019,6000000,5000000
314341,Chris Willock,West Bromwich Albion,1000000,Wypożyczenie,GB2,2019,4000000,3000000
314341,Chris Willock,Huddersfield Town,1000000,Wypożyczenie,GB2,2019,4000000,3000000
467599,Ben Wilmot,Swansea City,1000000,Wypożyczenie,GB2,2019,6000000,5000000
195637,Mason Bennett,FC Millwall,1000000,Wypożyczenie,GB2,2019,1000000,0
56100,Leon Balogun,Wigan Athletic,1000000,Wypożyczenie,GB2,2019,400000,-600000
44741,Beram Kayal,Charlton Athletic,1000000,Wypożyczenie,GB2,2019,300000,-700000
175745,Brad Smith,Cardiff City,1000000,Wypożyczenie,GB2,2019,1000000,0
314237,Rushian Hepburn-Murphy,Derby County,1000000,Wypożyczenie,GB2,2019,200000,-800000
314237,Rushian Hepburn-Murphy,Tranmere Rovers,1000000,Wypożyczenie,GB3,2019,200000,-800000
314237,Rushian Hepburn-Murphy,Cambridge United,1000000,Wypożyczenie,GB4,2018,200000,-800000
58097,John Bostock,Nottingham Forest,1000000,Wypożyczenie,GB2,2019,0,-1000000
77932,Jefferson Montero,Birmingham City,1000000,Wypożyczenie,GB2,2019,250000,-750000
77932,Jefferson Montero,West Bromwich Albion,1000000,Wypożyczenie,GB2,2018,250000,-750000
324223,James Bree,Luton Town,1000000,Wypożyczenie,GB2,2019,3000000,2000000
324223,James Bree,Ipswich Town,1000000,Wypożyczenie,GB2,2018,3000000,2000000
242606,Josh Cullen,Charlton Athletic,1000000,Wypożyczenie,GB2,2019,10000000,9000000
242606,Josh Cullen,Charlton Athletic,1000000,Wypożyczenie,GB3,2018,10000000,9000000
477704,Mallik Wilks,Hull City,900000,Wypożyczenie,GB2,2019,700000,-200000
477704,Mallik Wilks,Doncaster Rovers,0,Wypożyczenie,GB3,2018,700000,700000
337284,Ovie Ejaria,FC Reading,900000,Wypożyczenie,GB2,2019,2000000,1100000
337284,Ovie Ejaria,FC Reading,900000,Wypożyczenie,GB2,2018,2000000,1100000
128907,Ravel Morrison,FC Middlesbrough,750000,Wypożyczenie,GB2,2019,500000,-250000
292822,Aldo Kalulu,Swansea City,750000,Wypożyczenie,GB2,2019,1000000,250000
129054,David Davis,Charlton Athletic,750000,Wypożyczenie,GB2,2019,250000,-500000
24496,Bartosz Bialkowski,FC Millwall,750000,Wypożyczenie,GB2,2019,250000,-500000
150076,Ayub Masika,FC Reading,650000,Wypożyczenie,GB2,2019,350000,-300000
61583,Eunan O'Kane,Luton Town,500000,Wypożyczenie,GB2,2019,0,-500000
61583,Eunan O'Kane,Luton Town,750000,Wypożyczenie,GB3,2018,0,-750000
329813,João Virgínia,FC Reading,500000,Wypożyczenie,GB2,2019,700000,200000
67283,Ben Hamer,Derby County,500000,Wypożyczenie,GB2,2019,250000,-250000
105565,Mark Duffy,Stoke City,500000,Wypożyczenie,GB2,2019,0,-500000
345772,Bright Enobakhare,Wigan Athletic,500000,Wypożyczenie,GB2,2019,200000,-300000
345772,Bright Enobakhare,Coventry City,500000,Wypożyczenie,GB3,2018,200000,-300000
346551,Kamil Grabara,Huddersfield Town,400000,Wypożyczenie,GB2,2019,5000000,4600000
361516,Kilian Ludewig,FC Barnsley,300000,Wypożyczenie,GB2,2019,500000,200000
3539,Luke Steele,FC Millwall,150000,Wypożyczenie,GB2,2019,0,-150000
258912,Luke Amos,Queens Park Rangers,100000,Wypożyczenie,GB2,2019,500000,400000
365770,Alexandru Dobre,Wigan Athletic,100000,Wypożyczenie,GB2,2019,1000000,900000
365770,Alexandru Dobre,Yeovil Town,100000,Wypożyczenie,GB4,2018,1000000,900000
495602,Moha Ramos,Birmingham City,50000,Wypożyczenie,GB2,2019,25000,-25000
335721,Ben White,Leeds United,0,Wypożyczenie,GB2,2019,50000000,50000000
335721,Ben White,Peterborough United,0,Wypożyczenie,GB3,2018,50000000,50000000
398402,Sam Surridge,Swansea City,0,Wypożyczenie,GB2,2019,3000000,3000000
398402,Sam Surridge,Oldham Athletic,0,Wypożyczenie,GB4,2018,3000000,3000000
382553,Luke Bolton,Luton Town,0,Wypożyczenie,GB2,2019,800000,800000
382553,Luke Bolton,Wycombe Wanderers,0,Wypożyczenie,GB3,2018,800000,800000
511802,Rocky Bushiri,FC Blackpool,1000000,Wypożyczenie,GB3,2019,400000,-600000
40612,Liam Bridcutt,Lincoln City,1000000,Wypożyczenie,GB3,2019,250000,-750000
40612,Liam Bridcutt,Bolton Wanderers,1000000,Wypożyczenie,GB3,2019,250000,-750000
258879,Cameron Borthwick-Jackson,Tranmere Rovers,1000000,Wypożyczenie,GB3,2019,300000,-700000
258879,Cameron Borthwick-Jackson,Oldham Athletic,1000000,Wypożyczenie,GB4,2019,300000,-700000
258879,Cameron Borthwick-Jackson,Scunthorpe United,3000000,Wypożyczenie,GB3,2018,300000,-2700000
128910,George Thorne,Oxford United,1000000,Wypożyczenie,GB3,2019,0,-1000000
128910,George Thorne,Luton Town,1000000,Wypożyczenie,GB3,2018,0,-1000000
293746,Ross McCrorie,FC Portsmouth,1000000,Wypożyczenie,GB3,2019,750000,-250000
167393,James Husband,FC Blackpool,1000000,Wypożyczenie,GB3,2019,600000,-400000
167393,James Husband,Fleetwood Town,1000000,Wypożyczenie,GB3,2018,600000,-400000
125850,Marc McNulty,AFC Sunderland,1000000,Wypożyczenie,GB3,2019,500000,-500000
110668,Laurens De Bock,AFC Sunderland,1000000,Wypożyczenie,GB3,2019,600000,-400000
110860,Luke Garbutt,Ipswich Town,750000,Wypożyczenie,GB3,2019,300000,-450000
110860,Luke Garbutt,Oxford United,1000000,Wypożyczenie,GB3,2018,300000,-700000
391470,Marcus Browne,Oxford United,750000,Wypożyczenie,GB3,2019,300000,-450000
391470,Marcus Browne,Oxford United,250000,Wypożyczenie,GB3,2018,300000,50000
296582,Max O'Leary,Shrewsbury Town,750000,Wypożyczenie,GB3,2019,800000,50000
121265,Toto Nsiala,Bolton Wanderers,750000,Wypożyczenie,GB3,2019,300000,-450000
277782,Chris Cadden,Oxford United,700000,Wypożyczenie,GB3,2019,650000,-50000
121260,Conor McAleny,Shrewsbury Town,500000,Wypożyczenie,GB3,2019,175000,-325000
337787,Connor Ronan,FC Blackpool,500000,Wypożyczenie,GB3,2019,800000,300000
337787,Connor Ronan,FC Walsall,250000,Wypożyczenie,GB3,2018,800000,550000
258188,Rolando Aarons,Wycombe Wanderers,500000,Wypożyczenie,GB3,2019,300000,-200000
258188,Rolando Aarons,Sheffield Wednesday,500000,Wypożyczenie,GB2,2018,300000,-200000
340310,Marc Bola,FC Blackpool,500000,Wypożyczenie,GB3,2019,1000000,500000
156939,Ben Heneghan,FC Blackpool,500000,Wypożyczenie,GB3,2019,250000,-250000
156939,Ben Heneghan,FC Blackpool,400000,Wypożyczenie,GB3,2018,250000,-150000
583255,Antoine Semenyo,AFC Sunderland,500000,Wypożyczenie,GB3,2019,9000000,8500000
583255,Antoine Semenyo,Newport County,0,Wypożyczenie,GB4,2018,9000000,9000000
227185,Jason McCarthy,Wycombe Wanderers,500000,Wypożyczenie,GB3,2019,350000,-150000
30471,James Vaughan,Tranmere Rovers,500000,Wypożyczenie,GB3,2019,0,-500000
30471,James Vaughan,FC Portsmouth,500000,Wypożyczenie,GB3,2018,0,-500000
167265,Cameron McGeehan,FC Portsmouth,500000,Wypożyczenie,GB3,2019,600000,100000
258924,Jordan Rossiter,Fleetwood Town,450000,Wypożyczenie,GB3,2019,250000,-200000
258924,Jordan Rossiter,FC Bury,450000,Wypożyczenie,GB4,2018,250000,-200000
392375,Jake Hastie,Rotherham United,450000,Wypożyczenie,GB3,2019,200000,-250000
298231,Courtney Baker-Richardson,Accrington Stanley,350000,Wypożyczenie,GB3,2019,250000,-100000
372240,Mads Bech Sörensen,AFC Wimbledon,350000,Wypożyczenie,GB3,2019,4000000,3650000
396174,Jimmy Dunne,Fleetwood Town,300000,Wypożyczenie,GB3,2019,3000000,2700000
396174,Jimmy Dunne,AFC Sunderland,300000,Wypożyczenie,GB3,2018,3000000,2700000
413402,Lewie Coyle,Fleetwood Town,250000,Wypożyczenie,GB3,2019,800000,550000
325104,Josh Ginnelly,Bristol Rovers,250000,Wypożyczenie,GB3,2019,700000,450000
226219,Sean Raggett,FC Portsmouth,250000,Wypożyczenie,GB3,2019,400000,150000
226219,Sean Raggett,Rotherham United,250000,Wypożyczenie,GB2,2018,400000,150000
255626,Conor Shaughnessy,Burton Albion,250000,Wypożyczenie,GB3,2019,200000,-50000
255626,Conor Shaughnessy,Mansfield Town,250000,Wypożyczenie,GB4,2019,200000,-50000
214928,Kean Bryan,Bolton Wanderers,250000,Wypożyczenie,GB3,2019,900000,650000
562256,Mikael Ndjoli,FC Gillingham,250000,Wypożyczenie,GB3,2019,0,-250000
183283,Jordan Graham,FC Gillingham,250000,Wypożyczenie,GB3,2019,300000,50000
183283,Jordan Graham,Ipswich Town,500000,Wypożyczenie,GB2,2018,300000,-200000
183283,Jordan Graham,Oxford United,500000,Wypożyczenie,GB3,2018,300000,-200000
199522,Donervon Daniels,Doncaster Rovers,250000,Wypożyczenie,GB3,2019,250000,0
128895,Jak Alnwick,FC Blackpool,250000,Wypożyczenie,GB3,2019,400000,150000
128895,Jak Alnwick,Scunthorpe United,250000,Wypożyczenie,GB3,2018,400000,150000
279471,Sam Hart,Shrewsbury Town,250000,Wypożyczenie,GB3,2019,150000,-100000
279471,Sam Hart,AFC Rochdale,100000,Wypożyczenie,GB3,2018,150000,50000
279471,Sam Hart,Southend United,100000,Wypożyczenie,GB3,2018,150000,50000
338673,Thibaud Verlinden,Bolton Wanderers,250000,Wypożyczenie,GB3,2019,600000,350000
392774,Kane Wilson,Tranmere Rovers,250000,Wypożyczenie,GB3,2019,300000,50000
392774,Kane Wilson,FC Walsall,250000,Wypożyczenie,GB3,2018,300000,50000
392774,Kane Wilson,Exeter City,250000,Wypożyczenie,GB4,2018,300000,50000
325200,Jason Lokilo,Doncaster Rovers,200000,Wypożyczenie,GB3,2019,550000,350000
298091,Harry Souttar,Fleetwood Town,200000,Wypożyczenie,GB3,2019,15000000,14800000
298091,Harry Souttar,Fleetwood Town,200000,Wypożyczenie,GB3,2018,15000000,14800000
250870,Seny Dieng,Doncaster Rovers,150000,Wypożyczenie,GB3,2019,1000000,850000
250870,Seny Dieng,FC Stevenage,100000,Wypożyczenie,GB4,2018,1000000,900000
213847,Jordan Roberts,FC Gillingham,150000,Wypożyczenie,GB3,2019,300000,150000
213847,Jordan Roberts,Lincoln City,100000,Wypożyczenie,GB4,2018,300000,200000
292139,Sammie Szmodics,Peterborough United,150000,Wypożyczenie,GB3,2019,1000000,850000
322089,Benny Ashley-Seal,Accrington Stanley,150000,Wypożyczenie,GB3,2019,50000,-100000
342018,Tennai Watson,Coventry City,150000,Wypożyczenie,GB3,2019,200000,50000
342018,Tennai Watson,AFC Wimbledon,100000,Wypożyczenie,GB3,2018,200000,100000
104677,Jake Wright,Bolton Wanderers,150000,Wypożyczenie,GB3,2019,0,-150000
429563,Patrik Gunnarsson,Southend United,150000,Wypożyczenie,GB3,2019,700000,550000
340990,Alfie Jones,FC Gillingham,100000,Wypożyczenie,GB3,2019,1000000,900000
344987,Victor Adeboyejo,Bristol Rovers,100000,Wypożyczenie,GB3,2019,700000,600000
344987,Victor Adeboyejo,Cambridge United,100000,Wypożyczenie,GB4,2019,700000,600000
504910,Connor Simpson,Accrington Stanley,100000,Wypożyczenie,GB3,2019,0,-100000
504910,Connor Simpson,Carlisle United,0,Wypożyczenie,GB4,2018,0,0
425865,Callum Lang,Shrewsbury Town,100000,Wypożyczenie,GB3,2019,1000000,900000
425865,Callum Lang,Oldham Athletic,0,Wypożyczenie,GB4,2018,1000000,1000000
317032,Alex Jakubiak,FC Gillingham,100000,Wypożyczenie,GB3,2019,150000,50000
317032,Alex Jakubiak,Bristol Rovers,100000,Wypożyczenie,GB3,2018,150000,50000
320913,Anthony Georgiou,Ipswich Town,50000,Wypożyczenie,GB3,2019,150000,100000
320913,Anthony Georgiou,Bolton Wanderers,50000,Wypożyczenie,GB3,2019,150000,100000
270571,Aaron Chapman,Tranmere Rovers,25000,Wypożyczenie,GB3,2019,0,-25000
148683,Alex Woodyard,Tranmere Rovers,25000,Wypożyczenie,GB3,2019,200000,175000
396286,Ethan Hamilton,Southend United,0,Wypożyczenie,GB3,2019,350000,350000
396286,Ethan Hamilton,Bolton Wanderers,0,Wypożyczenie,GB3,2019,350000,350000
396286,Ethan Hamilton,AFC Rochdale,0,Wypożyczenie,GB3,2018,350000,350000
314365,Sadou Diallo,Accrington Stanley,0,Wypożyczenie,GB3,2019,75000,75000
314284,Layton Ndukwu,Southend United,0,Wypożyczenie,GB3,2019,100000,100000
403151,Robert Sánchez,AFC Rochdale,0,Wypożyczenie,GB3,2019,32000000,32000000
403151,Robert Sánchez,Forest Green Rovers,0,Wypożyczenie,GB4,2018,32000000,32000000
399373,Morgan Feeney,Tranmere Rovers,0,Wypożyczenie,GB3,2019,175000,175000
371262,Callum O'Hare,Coventry City,0,Wypożyczenie,GB3,2019,4000000,4000000
371262,Callum O'Hare,Carlisle United,0,Wypożyczenie,GB4,2018,4000000,4000000
256773,Dan Barlaser,Rotherham United,0,Wypożyczenie,GB3,2019,2000000,2000000
256773,Dan Barlaser,Accrington Stanley,0,Wypożyczenie,GB3,2018,2000000,2000000
431422,Nathan Trott,AFC Wimbledon,0,Wypożyczenie,GB3,2019,400000,400000
359199,Andy Fisher,Milton Keynes Dons,0,Wypożyczenie,GB3,2019,500000,500000
359199,Andy Fisher,Northampton Town,0,Wypożyczenie,GB4,2019,500000,500000
293507,Joe Morrell,Lincoln City,0,Wypożyczenie,GB3,2019,400000,400000
503749,Jacob Ramsey,Doncaster Rovers,0,Wypożyczenie,GB3,2019,32000000,32000000
490970,Ísak Snaer Thorvaldsson,Fleetwood Town,0,Wypożyczenie,GB3,2019,400000,400000
640280,Giles Phillips,Wycombe Wanderers,0,Wypożyczenie,GB3,2019,0,0
479939,Michael Folivi,AFC Wimbledon,0,Wypożyczenie,GB3,2019,0,0
479939,Michael Folivi,AFC Wimbledon,0,Wypożyczenie,GB3,2018,0,0
411495,Max Sanders,AFC Wimbledon,0,Wypożyczenie,GB3,2019,250000,250000
523712,Jordan Ponticelli,Tranmere Rovers,0,Wypożyczenie,GB3,2019,0,0
523712,Jordan Ponticelli,Macclesfield Town FC,0,Wypożyczenie,GB4,2018,0,0
652517,Julien Lamy,AFC Wimbledon,0,Wypożyczenie,GB3,2019,150000,150000
425894,Cameron John,Doncaster Rovers,0,Wypożyczenie,GB3,2019,175000,175000
98827,Ousseynou Cissé,Leyton Orient,700000,Wypożyczenie,GB4,2019,0,-700000
68335,Eoin Doyle,Swindon Town,650000,Wypożyczenie,GB4,2019,300000,-350000
345759,Zak Rudden,Plymouth Argyle,400000,Wypożyczenie,GB4,2019,300000,-100000
344588,Glenn Middleton,Bradford City,400000,Wypożyczenie,GB4,2019,500000,100000
195628,Jack Baldwin,Salford City,400000,Wypożyczenie,GB4,2019,400000,0
121236,Rob Hall,Forest Green Rovers,400000,Wypożyczenie,GB4,2019,0,-400000
38085,Filipe Morais,Oldham Athletic,350000,Wypożyczenie,GB4,2019,0,-350000
156764,Gavin Reilly,Cheltenham Town,350000,Wypożyczenie,GB4,2019,0,-350000
25186,Mark Howard,Salford City,300000,Wypożyczenie,GB4,2019,0,-300000
186597,Tom Nichols,Cheltenham Town,300000,Wypożyczenie,GB4,2019,300000,0
222024,Nathan Thomas,Carlisle United,250000,Wypożyczenie,GB4,2019,0,-250000
222024,Nathan Thomas,Notts County,250000,Wypożyczenie,GB4,2018,0,-250000
222024,Nathan Thomas,Carlisle United,250000,Wypożyczenie,GB4,2018,0,-250000
258887,Tafari Moore,Colchester United,200000,Wypożyczenie,GB4,2019,0,-200000
39514,Theo Robinson,Colchester United,200000,Wypożyczenie,GB4,2019,0,-200000
39514,Theo Robinson,Swindon Town,200000,Wypożyczenie,GB4,2018,0,-200000
136167,Chuma Anene,Crewe Alexandra,200000,Wypożyczenie,GB4,2019,0,-200000
31698,Anthony Grant,Swindon Town,200000,Wypożyczenie,GB4,2019,100000,-100000
183284,Ryan Inniss,Newport County,150000,Wypożyczenie,GB4,2019,300000,150000
184007,Rory Gaffney,FC Walsall,150000,Wypożyczenie,GB4,2019,100000,-50000
351933,Ashley Hunter,Salford City,150000,Wypożyczenie,GB4,2019,200000,50000
66956,Junior Brown,Scunthorpe United,150000,Wypożyczenie,GB4,2019,0,-150000
129074,Jake Jervis,Salford City,150000,Wypożyczenie,GB4,2019,250000,100000
129074,Jake Jervis,AFC Wimbledon,150000,Wypożyczenie,GB3,2018,250000,100000
566815,Connor Kirby,Macclesfield Town FC,100000,Wypożyczenie,GB4,2019,0,-100000
247594,Christoffer Mafoumbi,FC Morecambe,100000,Wypożyczenie,GB4,2019,100000,0
431643,Rory Holden,FC Walsall,100000,Wypożyczenie,GB4,2019,100000,0
431643,Rory Holden,AFC Rochdale,0,Wypożyczenie,GB3,2018,100000,100000
351261,Jerry Yates,Swindon Town,100000,Wypożyczenie,GB4,2019,3000000,2900000
351261,Jerry Yates,Carlisle United,100000,Wypożyczenie,GB4,2018,3000000,2900000
186923,Jack Rose,FC Walsall,100000,Wypożyczenie,GB4,2019,200000,100000
319779,George Cooper,Plymouth Argyle,100000,Wypożyczenie,GB4,2019,0,-100000
258882,Callum Cooke,Bradford City,100000,Wypożyczenie,GB4,2019,250000,150000
364803,Scott Wharton,Northampton Town,100000,Wypożyczenie,GB4,2019,1000000,900000
364803,Scott Wharton,Lincoln City,100000,Wypożyczenie,GB4,2018,1000000,900000
364803,Scott Wharton,FC Bury,100000,Wypożyczenie,GB4,2018,1000000,900000
452683,Josh Dacres-Cogley,Crawley Town,100000,Wypożyczenie,GB4,2019,250000,150000
318799,Otis Khan,Newport County,75000,Wypożyczenie,GB4,2019,150000,75000
183837,Gregor Zabret,Oldham Athletic,75000,Wypożyczenie,GB4,2019,75000,0
147623,Carl Piergianni,Oldham Athletic,50000,Wypożyczenie,GB4,2019,300000,250000
370551,Adam May,Swindon Town,50000,Wypożyczenie,GB4,2019,300000,250000
300908,Owen Evans,Macclesfield Town FC,50000,Wypożyczenie,GB4,2019,175000,125000
300908,Owen Evans,Cheltenham Town,50000,Wypożyczenie,GB4,2019,175000,125000
268451,Emmanuel Dieseruvwe,Oldham Athletic,50000,Wypożyczenie,GB4,2019,0,-50000
201553,Ashley Smith-Brown,Oldham Athletic,0,Wypożyczenie,GB4,2019,0,0
278501,Paul Mullin,Cambridge United,0,Wypożyczenie,GB4,2019,0,0
48965,Shaun Miller,FC Morecambe,0,Wypożyczenie,GB4,2019,0,0
248578,Dale Gorman,Newport County,0,Wypożyczenie,GB4,2019,0,0
255788,Cameron Burgess,Salford City,0,Wypożyczenie,GB4,2019,500000,500000
27053,Conrad Logan,Forest Green Rovers,0,Wypożyczenie,GB4,2019,0,0
401313,Canice Carroll,Carlisle United,0,Wypożyczenie,GB4,2019,0,0
401313,Canice Carroll,Swindon Town,0,Wypożyczenie,GB4,2018,0,0
339013,Mason Bloomfield,Crawley Town,0,Wypożyczenie,GB4,2019,0,0
246183,Billy Waters,Newport County,0,Wypożyczenie,GB4,2019,0,0
246183,Billy Waters,Cheltenham Town,0,Wypożyczenie,GB4,2018,0,0
181168,Danny Whitehead,Macclesfield Town FC,0,Wypożyczenie,GB4,2019,0,0
244040,Lloyd Jones,Northampton Town,0,Wypożyczenie,GB4,2019,300000,300000
244040,Lloyd Jones,Plymouth Argyle,100000,Wypożyczenie,GB3,2018,300000,200000
52822,Craig Mackail-Smith,FC Stevenage,0,Wypożyczenie,GB4,2019,0,0
52822,Craig Mackail-Smith,Notts County,0,Wypożyczenie,GB4,2018,0,0
396860,Josh Grant,Plymouth Argyle,0,Wypożyczenie,GB4,2019,200000,200000
396860,Josh Grant,Yeovil Town,0,Wypożyczenie,GB4,2018,200000,200000
356569,Olufela Olomola,Carlisle United,0,Wypożyczenie,GB4,2019,0,0
356569,Olufela Olomola,Yeovil Town,0,Wypożyczenie,GB4,2018,0,0
397102,Josh Benson,Grimsby Town,0,Wypożyczenie,GB4,2019,300000,300000
693095,Jacob Greaves,Cheltenham Town,0,Wypożyczenie,GB4,2019,8000000,8000000
411480,Jack Evans,Mansfield Town,0,Wypożyczenie,GB4,2019,0,0
384535,Michael Luyambula,Crawley Town,0,Wypożyczenie,GB4,2019,0,0
364711,Ryan Loft,Carlisle United,0,Wypożyczenie,GB4,2019,250000,250000
632577,Harvey Bradbury,FC Morecambe,0,Wypożyczenie,GB4,2019,0,0
425873,Luke Burgess,Salford City,0,Wypożyczenie,GB4,2019,0,0
422930,Elias Sörensen,Carlisle United,0,Wypożyczenie,GB4,2019,0,0
422930,Elias Sörensen,FC Blackpool,0,Wypożyczenie,GB3,2018,0,0
312553,Liam Gibson,Grimsby Town,0,Wypożyczenie,GB4,2019,150000,150000
312553,Liam Gibson,Accrington Stanley,0,Wypożyczenie,GB3,2018,150000,150000
476794,Christian N'Guessan,Oldham Athletic,0,Wypożyczenie,GB4,2019,0,0
340921,Jake Doyle-Hayes,Cheltenham Town,0,Wypożyczenie,GB4,2019,500000,500000
340921,Jake Doyle-Hayes,Cambridge United,0,Wypożyczenie,GB4,2018,500000,500000
475441,Nathan Sheron,FC Walsall,0,Wypożyczenie,GB4,2019,0,0
251838,Dylan Connolly,Bradford City,0,Wypożyczenie,GB4,2019,300000,300000
606810,Max Sheaf,Cheltenham Town,0,Wypożyczenie,GB4,2019,0,0
511622,Michael Nottingham,Crewe Alexandra,0,Wypożyczenie,GB4,2019,150000,150000
533849,Taylor Maloney,Newport County,0,Wypożyczenie,GB4,2019,0,0
532107,Ben Folami,FC Stevenage,0,Wypożyczenie,GB4,2019,450000,450000
647138,Danny McNamara,Newport County,0,Wypożyczenie,GB4,2019,3000000,3000000
420811,George Tanner,FC Morecambe,0,Wypożyczenie,GB4,2019,300000,300000
420811,George Tanner,Salford City,0,Wypożyczenie,GB4,2019,300000,300000
403574,Elliot Watt,Carlisle United,0,Wypożyczenie,GB4,2019,400000,400000
354111,Joe Leesley,FC Stevenage,0,Wypożyczenie,GB4,2019,0,0
608180,Brendan Wiredu,Colchester United,0,Wypożyczenie,GB4,2019,350000,350000
399436,Ben Liddle,Scunthorpe United,0,Wypożyczenie,GB4,2019,0,0
399436,Ben Liddle,Forest Green Rovers,0,Wypożyczenie,GB4,2018,0,0
431424,George Marsh,Leyton Orient,0,Wypożyczenie,GB4,2019,150000,150000
469106,Sam French,FC Stevenage,0,Wypożyczenie,GB4,2019,0,0
324502,David Parkhouse,FC Stevenage,0,Wypożyczenie,GB4,2019,50000,50000
504944,Eddie Clarke,Macclesfield Town FC,0,Wypożyczenie,GB4,2019,0,0
189751,Jevani Brown,Forest Green Rovers,0,Wypożyczenie,GB4,2019,300000,300000
331726,Tammy Abraham,Aston Villa,10000000,Wypożyczenie,GB2,2018,45000000,35000000
121279,Tom Carroll,Aston Villa,7000000,Wypożyczenie,GB2,2018,1000000,-6000000
348623,Mason Holgate,West Bromwich Albion,7000000,Wypożyczenie,GB2,2018,12000000,5000000
48950,Jordan Rhodes,Norwich City,6000000,Wypożyczenie,GB2,2018,400000,-5600000
198589,Lewis Baker,Leeds United,5000000,Wypożyczenie,GB2,2018,3000000,-2000000
198589,Lewis Baker,FC Reading,5000000,Wypożyczenie,GB2,2018,3000000,-2000000
181781,Léo Bonatini,Nottingham Forest,5000000,Wypożyczenie,GB2,2018,1000000,-4000000
148657,Tomas Kalas,Bristol City,5000000,Wypożyczenie,GB2,2018,1000000,-4000000
426192,Ben Brereton Díaz,Blackburn Rovers,5000000,Wypożyczenie,GB2,2018,16000000,11000000
67355,Ashley Williams,Stoke City,5000000,Wypożyczenie,GB2,2018,0,-5000000
93905,Muhamed Besic,FC Middlesbrough,5000000,Wypożyczenie,GB2,2018,1000000,-4000000
72768,Nélson Oliveira,FC Reading,5000000,Wypożyczenie,GB2,2018,1000000,-4000000
77001,Rajiv van La Parra,FC Middlesbrough,4000000,Wypożyczenie,GB2,2018,300000,-3700000
66994,Gary Madine,Sheffield United,4000000,Wypożyczenie,GB2,2018,400000,-3600000
236953,Sam Byram,Nottingham Forest,4000000,Wypożyczenie,GB2,2018,1000000,-3000000
151189,Yanic Wildschut,Bolton Wanderers,4000000,Wypożyczenie,GB2,2018,300000,-3700000
346483,Mason Mount,Derby County,4000000,Wypożyczenie,GB2,2018,65000000,61000000
61644,Jack Colback,Nottingham Forest,3000000,Wypożyczenie,GB2,2018,800000,-2200000
253677,Tyrone Mings,Aston Villa,3000000,Wypożyczenie,GB2,2018,25000000,22000000
417346,Jack Harrison,Leeds United,3000000,Wypożyczenie,GB2,2018,22000000,19000000
46154,Chris Martin,Hull City,3000000,Wypożyczenie,GB2,2018,300000,-2700000
196435,Saidy Janko,Nottingham Forest,3000000,Wypożyczenie,GB2,2018,1000000,-2000000
243589,Josh Onomah,Sheffield Wednesday,3000000,Wypożyczenie,GB2,2018,2000000,-1000000
73547,Oliver Norwood,Sheffield United,3000000,Wypożyczenie,GB2,2018,3000000,0
329723,Gil Dias,Nottingham Forest,3000000,Wypożyczenie,GB2,2018,2000000,-1000000
157490,Michael Hector,Sheffield Wednesday,3000000,Wypożyczenie,GB2,2018,900000,-2100000
91251,Cuco Martina,Stoke City,2000000,Wypożyczenie,GB2,2018,300000,-1700000
112668,Tomer Hemed,Queens Park Rangers,2000000,Wypożyczenie,GB2,2018,250000,-1750000
31642,Geoff Cameron,Queens Park Rangers,2000000,Wypożyczenie,GB2,2018,150000,-1850000
258015,Diogo Gonçalves,Nottingham Forest,2000000,Wypożyczenie,GB2,2018,5000000,3000000
37152,Tommy Elphick,Hull City,2000000,Wypożyczenie,GB2,2018,0,-2000000
216564,Marvin Johnson,Sheffield United,2000000,Wypożyczenie,GB2,2018,400000,-1600000
3306,Jonathan Walters,Ipswich Town,2000000,Wypożyczenie,GB2,2018,0,-2000000
118567,Ben Marshall,FC Millwall,1000000,Wypożyczenie,GB2,2018,0,-1000000
123397,Collin Quaner,Ipswich Town,1000000,Wypożyczenie,GB2,2018,0,-1000000
36939,Marc Pugh,Hull City,1000000,Wypożyczenie,GB2,2018,0,-1000000
110861,Gary Gardner,Birmingham City,1000000,Wypożyczenie,GB2,2018,800000,-200000
249271,Saeid Ezatolahi,FC Reading,1000000,Wypożyczenie,GB2,2018,400000,-600000
141573,George Saville,FC Middlesbrough,1000000,Wypożyczenie,GB2,2018,3000000,2000000
129049,Danny Batth,FC Middlesbrough,1000000,Wypożyczenie,GB2,2018,900000,-100000
221446,Lee Evans,Wigan Athletic,1000000,Wypożyczenie,GB2,2018,500000,-500000
351502,Tayo Edun,Ipswich Town,1000000,Wypożyczenie,GB2,2018,600000,-400000
145843,Ryan Leonard,FC Millwall,1000000,Wypożyczenie,GB2,2018,400000,-600000
118535,Will Keane,Ipswich Town,1000000,Wypożyczenie,GB2,2018,1000000,0
226968,Sam McQueen,FC Middlesbrough,1000000,Wypożyczenie,GB2,2018,0,-1000000
129893,Molla Wagué,Nottingham Forest,1000000,Wypożyczenie,GB2,2018,250000,-750000
111873,Emiliano Martínez,FC Reading,1000000,Wypożyczenie,GB2,2018,28000000,27000000
326363,André Moreira,Aston Villa,1000000,Wypożyczenie,GB2,2018,1000000,0
303254,Fikayo Tomori,Derby County,1000000,Wypożyczenie,GB2,2018,45000000,44000000
139173,Achraf Lazaar,Sheffield Wednesday,1000000,Wypożyczenie,GB2,2018,300000,-700000
134657,Omar Bogle,Birmingham City,750000,Wypożyczenie,GB2,2018,300000,-450000
134657,Omar Bogle,FC Portsmouth,500000,Wypożyczenie,GB3,2018,300000,-200000
139781,Tom Bradshaw,FC Millwall,750000,Wypożyczenie,GB2,2018,900000,150000
73472,Ben Amos,FC Millwall,750000,Wypożyczenie,GB2,2018,350000,-400000
47768,Alex Pearce,FC Millwall,750000,Wypożyczenie,GB2,2018,100000,-650000
36859,Leon Clarke,Wigan Athletic,750000,Wypożyczenie,GB2,2018,300000,-450000
134270,Dan Burn,Wigan Athletic,750000,Wypożyczenie,GB2,2018,12000000,11250000
349701,Antonee Robinson,Wigan Athletic,500000,Wypożyczenie,GB2,2018,12000000,11500000
268185,Joe Williams,Bolton Wanderers,500000,Wypożyczenie,GB2,2018,1000000,500000
57490,Jonathan Grounds,Bolton Wanderers,500000,Wypożyczenie,GB2,2018,100000,-400000
271997,Callum Elder,Ipswich Town,250000,Wypożyczenie,GB2,2018,800000,550000
262300,Ryan Manning,Rotherham United,250000,Wypożyczenie,GB2,2018,2000000,1750000
287528,Connor Mahoney,Birmingham City,250000,Wypożyczenie,GB2,2018,400000,150000
258915,Jay Dasilva,Bristol City,250000,Wypożyczenie,GB2,2018,2000000,1750000
258919,Dean Henderson,Sheffield United,250000,Wypożyczenie,GB2,2018,22000000,21750000
398065,Harvey Barnes,West Bromwich Albion,250000,Wypożyczenie,GB2,2018,32000000,31750000
114116,Richie Towell,Rotherham United,200000,Wypożyczenie,GB2,2018,200000,0
196722,Remi Matthews,Bolton Wanderers,200000,Wypożyczenie,GB2,2018,350000,150000
186901,Marek Rodak,Rotherham United,100000,Wypożyczenie,GB2,2018,3000000,2900000
417955,Zak Vyner,Rotherham United,100000,Wypożyczenie,GB2,2018,2000000,1900000
472423,Reece James,Wigan Athletic,0,Wypożyczenie,GB2,2018,70000000,70000000
255353,Christian Doidge,Bolton Wanderers,0,Wypożyczenie,GB2,2018,450000,450000
499381,Mitchel Candlin,Blackburn Rovers,0,Wypożyczenie,GB2,2018,0,0
434188,Rowan Roache,Derby County,0,Wypożyczenie,GB2,2018,0,0
104586,Lee Tomlin,Peterborough United,2000000,Wypożyczenie,GB3,2018,0,-2000000
246351,Zach Clough,AFC Rochdale,2000000,Wypożyczenie,GB3,2018,400000,-1600000
39827,Jacob Butterfield,Bradford City,2000000,Wypożyczenie,GB3,2018,0,-2000000
120706,Joe Mason,FC Portsmouth,1000000,Wypożyczenie,GB3,2018,250000,-750000
68183,David Meyler,Coventry City,1000000,Wypożyczenie,GB3,2018,0,-1000000
236513,Jerome Sinclair,Oxford United,1000000,Wypożyczenie,GB3,2018,0,-1000000
236513,Jerome Sinclair,AFC Sunderland,1000000,Wypożyczenie,GB3,2018,0,-1000000
48692,Jamie Ward,Charlton Athletic,1000000,Wypożyczenie,GB3,2018,0,-1000000
16660,Alex Baptiste,Luton Town,1000000,Wypożyczenie,GB3,2018,0,-1000000
209583,Jason Cummings,Peterborough United,800000,Wypożyczenie,GB3,2018,1000000,200000
209583,Jason Cummings,Luton Town,800000,Wypożyczenie,GB3,2018,1000000,200000
158534,Max Power,AFC Sunderland,750000,Wypożyczenie,GB3,2018,1000000,250000
52191,Stephen Henderson,Wycombe Wanderers,750000,Wypożyczenie,GB3,2018,300000,-450000
348756,Leonardo Lopes,FC Gillingham,750000,Wypożyczenie,GB3,2018,2000000,1250000
93626,Stuart O'Keefe,Plymouth Argyle,750000,Wypożyczenie,GB3,2018,125000,-625000
105695,Jason Holt,Fleetwood Town,750000,Wypożyczenie,GB3,2018,450000,-300000
311351,Lewis Morgan,AFC Sunderland,750000,Wypożyczenie,GB3,2018,6000000,5250000
169801,Cauley Woodrow,FC Barnsley,750000,Wypożyczenie,GB3,2018,1000000,250000
73120,Ahmed Kashi,Oxford United,700000,Wypożyczenie,GB3,2018,300000,-400000
227618,Greg Docherty,Shrewsbury Town,600000,Wypożyczenie,GB3,2018,900000,300000
85928,Danny Lafferty,Peterborough United,500000,Wypożyczenie,GB3,2018,50000,-450000
186924,Devante Cole,Burton Albion,500000,Wypożyczenie,GB3,2018,600000,100000
104686,Chris Maxwell,Charlton Athletic,500000,Wypożyczenie,GB3,2018,300000,-200000
427568,Aaron Ramsdale,AFC Wimbledon,500000,Wypożyczenie,GB3,2018,38000000,37500000
39515,Tommy Spurr,Fleetwood Town,500000,Wypożyczenie,GB3,2018,0,-500000
156899,Ricky Holmes,FC Gillingham,500000,Wypożyczenie,GB3,2018,0,-500000
156899,Ricky Holmes,Oxford United,500000,Wypożyczenie,GB3,2018,0,-500000
15921,Matt Jarvis,FC Walsall,500000,Wypożyczenie,GB3,2018,0,-500000
298240,George Thomas,Scunthorpe United,500000,Wypożyczenie,GB3,2018,300000,-200000
104167,David Wheeler,FC Portsmouth,500000,Wypożyczenie,GB3,2018,200000,-300000
104167,David Wheeler,Milton Keynes Dons,500000,Wypożyczenie,GB4,2018,200000,-300000
29154,Tony McMahon,Scunthorpe United,500000,Wypożyczenie,GB3,2018,0,-500000
262545,Connor Randall,AFC Rochdale,500000,Wypożyczenie,GB3,2018,450000,-50000
305274,Fred Onyedinma,Wycombe Wanderers,500000,Wypożyczenie,GB3,2018,600000,100000
186290,Harry Bunn,Southend United,500000,Wypożyczenie,GB3,2018,0,-500000
285551,Joel Coleman,Shrewsbury Town,500000,Wypożyczenie,GB3,2018,250000,-250000
236496,Charlie Colkett,Shrewsbury Town,400000,Wypożyczenie,GB3,2018,175000,-225000
177892,Graham Burke,FC Gillingham,350000,Wypożyczenie,GB3,2018,275000,-75000
129973,Billy King,FC Gillingham,350000,Wypożyczenie,GB3,2018,150000,-200000
283059,Josh Clarke,Burton Albion,350000,Wypożyczenie,GB3,2018,200000,-150000
278092,Jack Payne,Bradford City,350000,Wypożyczenie,GB3,2018,350000,0
146488,Samir Carruthers,Oxford United,350000,Wypożyczenie,GB3,2018,0,-350000
308388,Kyle Dempsey,Peterborough United,350000,Wypożyczenie,GB3,2018,600000,250000
121401,David Ball,Bradford City,300000,Wypożyczenie,GB3,2018,300000,0
261738,Joseph Dodoo,FC Blackpool,250000,Wypożyczenie,GB3,2018,300000,50000
354567,Stephen Humphrys,Scunthorpe United,250000,Wypożyczenie,GB3,2018,700000,450000
391127,Viv Solomon-Otabor,FC Portsmouth,250000,Wypożyczenie,GB3,2018,300000,50000
530384,Tom Pearce,Scunthorpe United,250000,Wypożyczenie,GB3,2018,300000,50000
14044,Andy Lonergan,AFC Rochdale,250000,Wypożyczenie,GB3,2018,200000,-50000
339943,Iké Ugbo,Scunthorpe United,250000,Wypożyczenie,GB3,2018,4000000,3750000
270988,Ben Purrington,Charlton Athletic,250000,Wypożyczenie,GB3,2018,450000,200000
270988,Ben Purrington,AFC Wimbledon,250000,Wypożyczenie,GB3,2018,450000,200000
193006,Mike-Steven Bähre,FC Barnsley,250000,Wypożyczenie,GB3,2018,300000,50000
129067,Ethan Ebanks-Landell,AFC Rochdale,250000,Wypożyczenie,GB3,2018,250000,0
386263,Josh Emmanuel,Shrewsbury Town,200000,Wypożyczenie,GB3,2018,250000,50000
173802,Oscar Threlkeld,Plymouth Argyle,200000,Wypożyczenie,GB3,2018,150000,-50000
349503,Conor Chaplin,Coventry City,200000,Wypożyczenie,GB3,2018,1000000,800000
337062,Ben Thompson,FC Portsmouth,200000,Wypożyczenie,GB3,2018,400000,200000
145923,Michael Ihiekwe,Accrington Stanley,150000,Wypożyczenie,GB3,2018,400000,250000
41115,Scott Laird,FC Walsall,150000,Wypożyczenie,GB3,2018,0,-150000
169566,Adam King,Peterborough United,150000,Wypożyczenie,GB3,2018,0,-150000
209291,Jack Bonham,Bristol Rovers,100000,Wypożyczenie,GB3,2018,500000,400000
452809,Tyler Denton,Peterborough United,100000,Wypożyczenie,GB3,2018,0,-100000
334964,Jorge Grant,Luton Town,100000,Wypożyczenie,GB3,2018,400000,300000
334964,Jorge Grant,Mansfield Town,100000,Wypożyczenie,GB4,2018,400000,300000
335182,Callum Guy,FC Blackpool,75000,Wypożyczenie,GB3,2018,200000,125000
319054,Tyler Garratt,AFC Wimbledon,75000,Wypożyczenie,GB3,2018,25000,-50000
215810,Tom King,AFC Wimbledon,50000,Wypożyczenie,GB3,2018,175000,125000
126587,Stefan Payne,Shrewsbury Town,0,Wypożyczenie,GB3,2018,0,0
226965,Lloyd Isgrove,FC Portsmouth,0,Wypożyczenie,GB3,2018,150000,150000
61833,Joe Martin,Bristol Rovers,0,Wypożyczenie,GB3,2018,0,0
253398,Joe Bunney,AFC Rochdale,0,Wypożyczenie,GB3,2018,0,0
253398,Joe Bunney,FC Blackpool,0,Wypożyczenie,GB3,2018,0,0
250331,Jermaine Anderson,Doncaster Rovers,0,Wypożyczenie,GB3,2018,0,0
236509,Connor Ogilvie,FC Gillingham,0,Wypożyczenie,GB3,2018,350000,350000
383046,Luke Armstrong,Accrington Stanley,0,Wypożyczenie,GB3,2018,300000,300000
343328,Nick Anderton,Accrington Stanley,0,Wypożyczenie,GB3,2018,200000,200000
976570,Christian,Fleetwood Town,0,Wypożyczenie,GB3,2018,0,0
382554,Tyrese Campbell,Shrewsbury Town,0,Wypożyczenie,GB3,2018,3000000,3000000
399393,Luke Charman,Accrington Stanley,0,Wypożyczenie,GB3,2018,0,0
285583,Harry Burgoyne,Plymouth Argyle,0,Wypożyczenie,GB3,2018,150000,150000
284717,Jake Flannigan,Burton Albion,0,Wypożyczenie,GB3,2018,0,0
359234,Alex Bradley,Burton Albion,0,Wypożyczenie,GB3,2018,0,0
364024,Paudie O'Connor,FC Blackpool,0,Wypożyczenie,GB3,2018,300000,300000
364024,Paudie O'Connor,Bradford City,0,Wypożyczenie,GB3,2018,300000,300000
612164,Charlie Fox,Wycombe Wanderers,0,Wypożyczenie,GB3,2018,175000,175000
560694,Lewis O'Brien,Bradford City,0,Wypożyczenie,GB3,2018,8000000,8000000
258914,Brad Collins,Burton Albion,0,Wypożyczenie,GB3,2018,700000,700000
481553,Connor Hall,Accrington Stanley,0,Wypożyczenie,GB3,2018,0,0
345251,Connor Johnson,FC Walsall,0,Wypożyczenie,GB3,2018,0,0
342047,Jack Fitzwater,FC Walsall,0,Wypożyczenie,GB3,2018,550000,550000
282821,Corey Blackett-Taylor,FC Walsall,0,Wypożyczenie,GB3,2018,300000,300000
415170,Randell Williams,Wycombe Wanderers,0,Wypożyczenie,GB3,2018,300000,300000
286496,Tahvon Campbell,FC Gillingham,0,Wypożyczenie,GB3,2018,0,0
470371,Shawn McCoulsky,Southend United,0,Wypożyczenie,GB3,2018,0,0
405978,Matty Platt,Accrington Stanley,0,Wypożyczenie,GB3,2018,200000,200000
256436,Magnus Norman,AFC Rochdale,0,Wypożyczenie,GB3,2018,0,0
411544,Sherwin Seedorf,Bradford City,0,Wypożyczenie,GB3,2018,0,0
130234,Nicky Ajose,Mansfield Town,750000,Wypożyczenie,GB4,2018,0,-750000
251289,Jordan Lyden,Oldham Athletic,500000,Wypożyczenie,GB4,2018,200000,-300000
235780,Mark O'Hara,Lincoln City,450000,Wypożyczenie,GB4,2018,500000,50000
120599,Marvin Sordell,Northampton Town,400000,Wypożyczenie,GB4,2018,0,-400000
29589,Ben Pringle,Grimsby Town,350000,Wypożyczenie,GB4,2018,0,-350000
29589,Ben Pringle,Tranmere Rovers,350000,Wypożyczenie,GB4,2018,0,-350000
121032,Aaron Taylor-Sinclair,Crewe Alexandra,250000,Wypożyczenie,GB4,2018,0,-250000
158330,Tyrone Barnett,Cheltenham Town,250000,Wypożyczenie,GB4,2018,0,-250000
174247,Luke McCullough,Tranmere Rovers,250000,Wypożyczenie,GB4,2018,50000,-200000
55851,Rob Milsom,Notts County,250000,Wypożyczenie,GB4,2018,125000,-125000
347666,Ryan Sweeney,Mansfield Town,250000,Wypożyczenie,GB4,2018,400000,150000
289845,Matty Willock,Crawley Town,250000,Wypożyczenie,GB4,2018,250000,0
204354,Adam Campbell,Carlisle United,250000,Wypożyczenie,GB4,2018,0,-250000
242412,Gethin Jones,Mansfield Town,250000,Wypożyczenie,GB4,2018,350000,100000
203451,Alex Jones,Cambridge United,200000,Wypożyczenie,GB4,2018,0,-200000
201438,Shay McCartan,Lincoln City,200000,Wypożyczenie,GB4,2018,100000,-100000
147621,Piero Mingoia,FC Morecambe,150000,Wypożyczenie,GB4,2018,0,-150000
34346,Louis Dodds,Port Vale FC,150000,Wypożyczenie,GB4,2018,0,-150000
233100,Lee Angol,Lincoln City,150000,Wypożyczenie,GB4,2018,150000,0
251485,Jordan Tillson,Cheltenham Town,150000,Wypożyczenie,GB4,2018,350000,200000
127983,Caolan Lavery,FC Bury,150000,Wypożyczenie,GB4,2018,200000,50000
238185,Rhys Healey,Milton Keynes Dons,150000,Wypożyczenie,GB4,2018,3000000,2850000
433842,Tom Field,Cheltenham Town,150000,Wypożyczenie,GB4,2018,75000,-75000
467540,James Brown,Lincoln City,150000,Wypożyczenie,GB4,2018,325000,175000
395842,Franklyn Akammadu,Tranmere Rovers,150000,Wypożyczenie,GB4,2018,50000,-100000
251335,Kieron Morris,Tranmere Rovers,150000,Wypożyczenie,GB4,2018,150000,0
95240,Sam Slocombe,Lincoln City,125000,Wypożyczenie,GB4,2018,0,-125000
355273,Ben Kennedy,Newport County,125000,Wypożyczenie,GB4,2018,75000,-50000
67375,Kristian Dennis,Grimsby Town,100000,Wypożyczenie,GB4,2018,150000,50000
392591,Chiedozie Ogbene,Exeter City,100000,Wypożyczenie,GB4,2018,2000000,1900000
263556,Joe Maguire,Crawley Town,100000,Wypożyczenie,GB4,2018,100000,0
228778,Kevin O'Connor,Crewe Alexandra,100000,Wypożyczenie,GB4,2018,50000,-50000
380473,Ilias Chair,FC Stevenage,100000,Wypożyczenie,GB4,2018,10000000,9900000
330607,Donovan Wilson,Exeter City,100000,Wypożyczenie,GB4,2018,150000,50000
270296,Botti Biabi,Macclesfield Town FC,100000,Wypożyczenie,GB4,2018,0,-100000
354303,Mathew Hudson,FC Bury,100000,Wypożyczenie,GB4,2018,0,-100000
369563,Liam Mandeville,FC Morecambe,100000,Wypożyczenie,GB4,2018,0,-100000
108654,Danny Rowe,Lincoln City,100000,Wypożyczenie,GB4,2018,150000,50000
350401,Sid Nelson,Tranmere Rovers,75000,Wypożyczenie,GB4,2018,0,-75000
350401,Sid Nelson,Swindon Town,75000,Wypożyczenie,GB4,2018,0,-75000
288952,Callum Roberts,Colchester United,75000,Wypożyczenie,GB4,2018,100000,25000
341042,Aaron Collins,Colchester United,75000,Wypożyczenie,GB4,2018,900000,825000
329055,Enes Mahmutovic,Yeovil Town,75000,Wypożyczenie,GB4,2018,250000,175000
250431,Jamie Sterry,Crewe Alexandra,75000,Wypożyczenie,GB4,2018,125000,50000
345767,Dylan Mottley-Henry,Tranmere Rovers,50000,Wypożyczenie,GB4,2018,0,-50000
346780,Jack Sowerby,Carlisle United,50000,Wypożyczenie,GB4,2018,175000,125000
280978,Fiacre Kelleher,Macclesfield Town FC,50000,Wypożyczenie,GB4,2018,175000,125000
127802,Mark Cullen,Carlisle United,0,Wypożyczenie,GB4,2018,0,0
193777,Charlie Raglan,Cheltenham Town,0,Wypożyczenie,GB4,2018,250000,250000
411239,Omari Patrick,Yeovil Town,0,Wypożyczenie,GB4,2018,125000,125000
158786,Luke Hendrie,Grimsby Town,0,Wypożyczenie,GB4,2018,150000,150000
340194,Regan Poole,Newport County,0,Wypożyczenie,GB4,2018,450000,450000
308635,Calum Dyson,FC Stevenage,0,Wypożyczenie,GB4,2018,0,0
287964,Ben Hall,Notts County,0,Wypożyczenie,GB4,2018,50000,50000
344012,Mark Harris,Port Vale FC,0,Wypożyczenie,GB4,2018,1000000,1000000
344012,Mark Harris,Newport County,0,Wypożyczenie,GB4,2018,1000000,1000000
527425,Luke Woolfenden,Swindon Town,0,Wypożyczenie,GB4,2018,700000,700000
420810,Ben Morris,Forest Green Rovers,0,Wypożyczenie,GB4,2018,0,0
320854,Timi Max Elsnik,Northampton Town,0,Wypożyczenie,GB4,2018,1000000,1000000
320854,Timi Max Elsnik,Mansfield Town,0,Wypożyczenie,GB4,2018,1000000,1000000
432179,Reece Cole,Yeovil Town,0,Wypożyczenie,GB4,2018,0,0
432179,Reece Cole,Macclesfield Town FC,0,Wypożyczenie,GB4,2018,0,0
425896,Adam Crookes,Lincoln City,0,Wypożyczenie,GB4,2018,0,0
425896,Adam Crookes,Port Vale FC,0,Wypożyczenie,GB4,2018,0,0
121331,Sam Jones,Cheltenham Town,0,Wypożyczenie,GB4,2018,0,0
526619,Malachi Napa,Macclesfield Town FC,0,Wypożyczenie,GB4,2018,0,0
261297,Kyle Howkins,Port Vale FC,0,Wypożyczenie,GB4,2018,0,0
470128,Sam Dalby,FC Morecambe,0,Wypożyczenie,GB4,2018,0,0
308615,Corey Whelan,Crewe Alexandra,0,Wypożyczenie,GB4,2018,150000,150000
473079,Harvey Gilmour,Tranmere Rovers,0,Wypożyczenie,GB4,2018,0,0
359692,George Cox,Northampton Town,0,Wypożyczenie,GB4,2018,900000,900000
407393,Richie Bennett,FC Morecambe,0,Wypożyczenie,GB4,2018,0,0
346469,Jaden Brown,Exeter City,0,Wypożyczenie,GB4,2018,200000,200000
419183,Charlie Cooper,Newport County,0,Wypożyczenie,GB4,2018,0,0
401320,Dara O'Shea,Exeter City,0,Wypożyczenie,GB4,2018,5000000,5000000
566408,Abo Eisa,Colchester United,0,Wypożyczenie,GB4,2018,100000,100000
319900,Elijah Adebayo,FC Stevenage,0,Wypożyczenie,GB4,2018,5000000,5000000
319900,Elijah Adebayo,Swindon Town,0,Wypożyczenie,GB4,2018,5000000,5000000
396165,Callum Whelan,Port Vale FC,0,Wypożyczenie,GB4,2018,0,0
266037,Joe Fryer,Carlisle United,0,Wypożyczenie,GB4,2018,0,0
493607,Matt Worthington,Forest Green Rovers,0,Wypożyczenie,GB4,2018,0,0
343302,Paul McKay,FC Morecambe,0,Wypożyczenie,GB4,2018,0,0
641441,Ali Koiki,Swindon Town,0,Wypożyczenie,GB4,2018,200000,200000
354134,Joe Powell,Northampton Town,0,Wypożyczenie,GB4,2018,500000,500000
287051,Alex Iacovitti,Oldham Athletic,0,Wypożyczenie,GB4,2018,450000,450000
399386,Josef Yarney,FC Morecambe,0,Wypożyczenie,GB4,2018,0,0
370138,Kellan Gordon,Lincoln City,0,Wypożyczenie,GB4,2018,125000,125000
396284,Zak Dearnley,Oldham Athletic,0,Wypożyczenie,GB4,2018,0,0
332338,Vashon Neufville,Newport County,0,Wypożyczenie,GB4,2018,125000,125000
337290,Shamal George,Tranmere Rovers,0,Wypożyczenie,GB4,2018,325000,325000
345758,Jamie Barjonas,FC Bury,0,Wypożyczenie,GB4,2018,0,0
476237,Steven Alzate,Swindon Town,0,Wypożyczenie,GB4,2018,4000000,4000000
242644,Moses Makasi,FC Stevenage,0,Wypożyczenie,GB4,2018,200000,200000
384264,Aden Baldwin,Cheltenham Town,0,Wypożyczenie,GB4,2018,0,0
435752,Ashley Nadesan,Carlisle United,0,Wypożyczenie,GB4,2018,300000,300000
379666,Jordan Gibson,FC Stevenage,0,Wypożyczenie,GB4,2018,250000,250000
359194,Lewis Hardcastle,Port Vale FC,0,Wypożyczenie,GB4,2018,0,0
575633,Sam Graham,Oldham Athletic,0,Wypożyczenie,GB4,2018,150000,150000
535054,Joe Piggott,FC Morecambe,0,Wypożyczenie,GB4,2018,0,0
425764,Kelsey Mooney,Cheltenham Town,0,Wypożyczenie,GB4,2018,0,0
425901,Toby Edser,Port Vale FC,0,Wypożyczenie,GB4,2018,0,0
282932,Bernard Mensah,Lincoln City,0,Wypożyczenie,GB4,2018,0,0
503759,Ben House,Swindon Town,0,Wypożyczenie,GB4,2018,200000,200000
291129,Harry McKirdy,Newport County,0,Wypożyczenie,GB4,2018,225000,225000
250730,Keston Davies,Notts County,0,Wypożyczenie,GB4,2018,75000,75000
425795,Callum Maycock,Macclesfield Town FC,0,Wypożyczenie,GB4,2018,0,0
399454,Alex Pattison,Yeovil Town,0,Wypożyczenie,GB4,2018,250000,250000
425872,Sam Stubbs,Notts County,0,Wypożyczenie,GB4,2018,250000,250000
387355,Nathan McGinley,Forest Green Rovers,0,Wypożyczenie,GB4,2018,375000,375000
