name,loaning_club,player_value_in_moment_of_transfer,transfer_cost,league,year,market_value_in_eur,delta_value
Amad Diallo,AFC Sunderland,15000000,Wypożyczenie,GB2,2022,13000000,-2000000
Marquinhos,Norwich City,10000000,Wypożyczenie,GB2,2022,12000000,2000000
Alex Mowatt,FC Middlesbrough,10000000,Wypożyczenie,GB2,2022,4000000,-6000000
Cameron Archer,FC Middlesbrough,8000000,Wypożyczenie,GB2,2022,10000000,2000000
Cameron Archer,Preston North End,500000,Wypożyczenie,GB2,2021,10000000,9500000
Tyler Roberts,Queens Park Rangers,8000000,Wypożyczenie,GB2,2022,4000000,-4000000
Isaac Hayden,Norwich City,8000000,Wypożyczenie,GB2,2022,4000000,-4000000
Joe Gelhardt,AFC Sunderland,8000000,Wypożyczenie,GB2,2022,8000000,0
Matheus Martins,FC Watford,7000000,Wypożyczenie,GB2,2022,7000000,0
Liam Delap,Preston North End,7000000,Wypożyczenie,GB2,2022,7000000,0
Liam Delap,Stoke City,1000000,Wypożyczenie,GB2,2022,7000000,6000000
Taylor Harwood-Bellis,FC Burnley,7000000,Wypożyczenie,GB2,2022,15000000,8000000
Taylor Harwood-Bellis,Stoke City,3000000,Wypożyczenie,GB2,2021,15000000,12000000
Taylor Harwood-Bellis,Blackburn Rovers,2000000,Wypożyczenie,GB2,2020,15000000,13000000
Hannibal,Birmingham City,6000000,Wypożyczenie,GB2,2022,8000000,2000000
Zack Steffen,FC Middlesbrough,6000000,Wypożyczenie,GB2,2022,4000000,-2000000
Axel Tuanzebe,Stoke City,6000000,Wypożyczenie,GB2,2022,6000000,0
Axel Tuanzebe,Aston Villa,1000000,Wypożyczenie,GB2,2018,6000000,5000000
Ian Maatsen,FC Burnley,5000000,Wypożyczenie,GB2,2022,9000000,4000000
Ian Maatsen,Coventry City,0,Wypożyczenie,GB2,2021,9000000,9000000
Ian Maatsen,Charlton Athletic,0,Wypożyczenie,GB3,2020,9000000,9000000
Sorba Thomas,Blackburn Rovers,5000000,Wypożyczenie,GB2,2022,5000000,0
Marvelous Nakamba,Luton Town,5000000,Wypożyczenie,GB2,2022,4000000,-1000000
Ethan Laird,Queens Park Rangers,5000000,Wypożyczenie,GB2,2022,5000000,0
Ethan Laird,AFC Bournemouth,5000000,Wypożyczenie,GB2,2021,5000000,0
Ethan Laird,Swansea City,1000000,Wypożyczenie,GB2,2021,5000000,4000000
Ethan Laird,Milton Keynes Dons,1000000,Wypożyczenie,GB3,2020,5000000,4000000
Jeff Hendrick,FC Reading,5000000,Wypożyczenie,GB2,2022,2000000,-3000000
Jeff Hendrick,Queens Park Rangers,7000000,Wypożyczenie,GB2,2021,2000000,-5000000
Aaron Connolly,Hull City,5000000,Wypożyczenie,GB2,2022,5000000,0
Aaron Connolly,FC Middlesbrough,7000000,Wypożyczenie,GB2,2021,5000000,-2000000
Aaron Connolly,Luton Town,0,Wypożyczenie,GB3,2018,5000000,5000000
Henrique Araújo,FC Watford,5000000,Wypożyczenie,GB2,2022,5000000,0
Rodrigo Muniz,FC Middlesbrough,5000000,Wypożyczenie,GB2,2022,5000000,0
Troy Parrott,Preston North End,5000000,Wypożyczenie,GB2,2022,4000000,-1000000
Troy Parrott,Milton Keynes Dons,3000000,Wypożyczenie,GB3,2021,4000000,1000000
Troy Parrott,FC Millwall,3000000,Wypożyczenie,GB2,2020,4000000,1000000
Troy Parrott,Ipswich Town,3000000,Wypożyczenie,GB3,2020,4000000,1000000
Jordan Beyer,FC Burnley,4000000,Wypożyczenie,GB2,2022,10000000,6000000
Dimitrios Pelkas,Hull City,4000000,Wypożyczenie,GB2,2022,3000000,-1000000
Mamadou Loum,FC Reading,4000000,Wypożyczenie,GB2,2022,3000000,-1000000
Ki-Jana Hoever,Stoke City,4000000,Wypożyczenie,GB2,2022,4000000,0
Kortney Hause,FC Watford,4000000,Wypożyczenie,GB2,2022,2000000,-2000000
Kortney Hause,Aston Villa,1000000,Wypożyczenie,GB2,2018,2000000,1000000
Krystian Bielik,Birmingham City,4000000,Wypożyczenie,GB2,2022,3000000,-1000000
Krystian Bielik,Charlton Athletic,2000000,Wypożyczenie,GB3,2018,3000000,1000000
Michael Obafemi,FC Burnley,4000000,Wypożyczenie,GB2,2022,4000000,0
Hamza Choudhury,FC Watford,4000000,Wypożyczenie,GB2,2022,5000000,1000000
Hassane Kamara,FC Watford,4000000,Wypożyczenie,GB2,2022,8000000,4000000
Rhys Williams,FC Blackpool,4000000,Wypożyczenie,GB2,2022,3000000,-1000000
Rhys Williams,Swansea City,5000000,Wypożyczenie,GB2,2021,3000000,-2000000
Callum Styles,FC Millwall,3000000,Wypożyczenie,GB2,2022,3000000,0
Callum Styles,FC Bury,250000,Wypożyczenie,GB4,2018,3000000,2750000
Tino Anjorin,Huddersfield Town,3000000,Wypożyczenie,GB2,2022,2000000,-1000000
Tino Anjorin,Huddersfield Town,3000000,Wypożyczenie,GB2,2021,2000000,-1000000
James McAtee,Sheffield United,3000000,Wypożyczenie,GB2,2022,6000000,3000000
Halil Dervisoglu,FC Burnley,3000000,Wypożyczenie,GB2,2022,2000000,-1000000
Charlie Cresswell,FC Millwall,3000000,Wypożyczenie,GB2,2022,5000000,2000000
Cody Drameh,Luton Town,3000000,Wypożyczenie,GB2,2022,3000000,0
Cody Drameh,Cardiff City,1000000,Wypożyczenie,GB2,2021,3000000,2000000
Malcolm Ebiowei,Hull City,3000000,Wypożyczenie,GB2,2022,3000000,0
Tyler Morton,Blackburn Rovers,3000000,Wypożyczenie,GB2,2022,7000000,4000000
Edouard Michut,AFC Sunderland,3000000,Wypożyczenie,GB2,2022,2000000,-1000000
Jaden Philogene,Cardiff City,3000000,Wypożyczenie,GB2,2022,2000000,-1000000
Jaden Philogene,Stoke City,500000,Wypożyczenie,GB2,2021,2000000,1500000
Ryan Giles,FC Middlesbrough,3000000,Wypożyczenie,GB2,2022,7000000,4000000
Ryan Giles,Blackburn Rovers,2000000,Wypożyczenie,GB2,2021,7000000,5000000
Ryan Giles,Cardiff City,1000000,Wypożyczenie,GB2,2021,7000000,6000000
Ryan Giles,Rotherham United,1000000,Wypożyczenie,GB2,2020,7000000,6000000
Ryan Giles,Coventry City,0,Wypożyczenie,GB2,2020,7000000,7000000
Ryan Giles,Coventry City,0,Wypożyczenie,GB3,2019,7000000,7000000
Ryan Giles,Shrewsbury Town,0,Wypożyczenie,GB3,2019,7000000,7000000
Oliver Burke,FC Millwall,3000000,Wypożyczenie,GB2,2022,3000000,0
Oliver Burke,FC Millwall,5000000,Wypożyczenie,GB2,2021,3000000,-2000000
Bersant Celina,Stoke City,3000000,Wypożyczenie,GB2,2022,3000000,0
Bersant Celina,Ipswich Town,3000000,Wypożyczenie,GB3,2021,3000000,0
Aaron Ramsey,FC Middlesbrough,3000000,Wypożyczenie,GB2,2022,5000000,2000000
Aaron Ramsey,Norwich City,1000000,Wypożyczenie,GB2,2022,5000000,4000000
Aaron Ramsey,Cheltenham Town,1000000,Wypożyczenie,GB3,2021,5000000,4000000
Jamie Shackleton,FC Millwall,2000000,Wypożyczenie,GB2,2022,2000000,0
Jonathan Panzo,Coventry City,2000000,Wypożyczenie,GB2,2022,3000000,1000000
Tommy Doyle,Sheffield United,2000000,Wypożyczenie,GB2,2022,5000000,3000000
Tommy Doyle,Cardiff City,1000000,Wypożyczenie,GB2,2021,5000000,4000000
Tim Iroegbunam,Queens Park Rangers,2000000,Wypożyczenie,GB2,2022,4000000,2000000
Sory Kaba,Cardiff City,2000000,Wypożyczenie,GB2,2022,2000000,0
Ben Pearson,Stoke City,2000000,Wypożyczenie,GB2,2022,2000000,0
Keinan Davis,FC Watford,2000000,Wypożyczenie,GB2,2022,3000000,1000000
Keinan Davis,Nottingham Forest,3000000,Wypożyczenie,GB2,2021,3000000,0
Niels Nkounkou,Cardiff City,2000000,Wypożyczenie,GB2,2022,2000000,0
Abdul-Rahman Baba,FC Reading,2000000,Wypożyczenie,GB2,2022,1000000,-1000000
Abdul-Rahman Baba,FC Reading,2000000,Wypożyczenie,GB2,2021,1000000,-1000000
Tariqe Fosu,Stoke City,2000000,Wypożyczenie,GB2,2022,2000000,0
Tariqe Fosu,Rotherham United,2000000,Wypożyczenie,GB2,2022,2000000,0
Ian Poveda,FC Blackpool,2000000,Wypożyczenie,GB2,2022,1000000,-1000000
Ian Poveda,Blackburn Rovers,1000000,Wypożyczenie,GB2,2021,1000000,0
Álvaro Fernandez,Preston North End,2000000,Wypożyczenie,GB2,2022,6000000,4000000
Marc Albrighton,West Bromwich Albion,2000000,Wypożyczenie,GB2,2022,2000000,0
Matija Sarkic,Stoke City,2000000,Wypożyczenie,GB2,2022,2000000,0
Matija Sarkic,Birmingham City,100000,Wypożyczenie,GB2,2021,2000000,1900000
Matija Sarkic,Shrewsbury Town,100000,Wypożyczenie,GB3,2020,2000000,1900000
Auston Trusty,Birmingham City,2000000,Wypożyczenie,GB2,2022,9000000,7000000
Charlie Patino,FC Blackpool,2000000,Wypożyczenie,GB2,2022,8000000,6000000
Josh Bowler,FC Blackpool,2000000,Wypożyczenie,GB2,2022,2000000,0
Josh Bowler,Hull City,0,Wypożyczenie,GB2,2019,2000000,2000000
Will Smallbone,Stoke City,2000000,Wypożyczenie,GB2,2022,2000000,0
Karl Darlow,Hull City,1000000,Wypożyczenie,GB2,2022,1000000,0
Nathan Tella,FC Burnley,1000000,Wypożyczenie,GB2,2022,12000000,11000000
Morgan Rogers,FC Blackpool,1000000,Wypożyczenie,GB2,2022,1000000,0
Morgan Rogers,AFC Bournemouth,1000000,Wypożyczenie,GB2,2021,1000000,0
Morgan Rogers,Lincoln City,1000000,Wypożyczenie,GB3,2020,1000000,0
Domingos Quina,Rotherham United,1000000,Wypożyczenie,GB2,2022,1000000,0
Domingos Quina,FC Fulham,3000000,Wypożyczenie,GB2,2021,1000000,-2000000
Domingos Quina,FC Barnsley,2000000,Wypożyczenie,GB2,2021,1000000,-1000000
Ciaran Clark,Sheffield United,1000000,Wypożyczenie,GB2,2022,700000,-300000
Przemyslaw Placheta,Birmingham City,1000000,Wypożyczenie,GB2,2022,2000000,1000000
Danel Sinani,Wigan Athletic,1000000,Wypożyczenie,GB2,2022,1000000,0
Danel Sinani,Huddersfield Town,550000,Wypożyczenie,GB2,2021,1000000,450000
Jamal Lowe,Queens Park Rangers,1000000,Wypożyczenie,GB2,2022,1000000,0
Gavin Kilkenny,Stoke City,1000000,Wypożyczenie,GB2,2022,700000,-300000
Gavin Kilkenny,Charlton Athletic,700000,Wypożyczenie,GB3,2022,700000,0
Ashley Fletcher,Wigan Athletic,1000000,Wypożyczenie,GB2,2022,800000,-200000
Anthony Knockaert,Huddersfield Town,1000000,Wypożyczenie,GB2,2022,1000000,0
Anthony Knockaert,Nottingham Forest,5000000,Wypożyczenie,GB2,2020,1000000,-4000000
Brooke Norton-Cuffy,Coventry City,1000000,Wypożyczenie,GB2,2022,1000000,0
Brooke Norton-Cuffy,Rotherham United,400000,Wypożyczenie,GB2,2022,1000000,600000
Brooke Norton-Cuffy,Lincoln City,0,Wypożyczenie,GB3,2021,1000000,1000000
Grant Hall,Rotherham United,1000000,Wypożyczenie,GB2,2022,900000,-100000
Clinton Mola,Blackburn Rovers,1000000,Wypożyczenie,GB2,2022,800000,-200000
Cesare Casadei,FC Reading,1000000,Wypożyczenie,GB2,2022,6000000,5000000
Theo Corbeanu,FC Blackpool,1000000,Wypożyczenie,GB2,2022,1000000,0
Theo Corbeanu,Milton Keynes Dons,1000000,Wypożyczenie,GB3,2021,1000000,0
Theo Corbeanu,Sheffield Wednesday,500000,Wypożyczenie,GB3,2021,1000000,500000
Dujon Sterling,Stoke City,1000000,Wypożyczenie,GB2,2022,800000,-200000
Dujon Sterling,FC Blackpool,900000,Wypożyczenie,GB2,2021,800000,-100000
Dujon Sterling,Wigan Athletic,0,Wypożyczenie,GB2,2019,800000,800000
Dujon Sterling,Coventry City,0,Wypożyczenie,GB3,2018,800000,800000
Conor Coventry,Rotherham United,1000000,Wypożyczenie,GB2,2022,1000000,0
Conor Coventry,Peterborough United,200000,Wypożyczenie,GB2,2021,1000000,800000
Conor Coventry,Milton Keynes Dons,300000,Wypożyczenie,GB3,2021,1000000,700000
Conor Coventry,Lincoln City,0,Wypożyczenie,GB3,2019,1000000,1000000
Joe Lumley,FC Reading,1000000,Wypożyczenie,GB2,2022,1000000,0
Joe Lumley,FC Gillingham,600000,Wypożyczenie,GB3,2020,1000000,400000
Joe Lumley,Doncaster Rovers,600000,Wypożyczenie,GB3,2020,1000000,400000
Reda Khadra,Birmingham City,1000000,Wypożyczenie,GB2,2022,1000000,0
Reda Khadra,Sheffield United,1000000,Wypożyczenie,GB2,2022,1000000,0
Reda Khadra,Blackburn Rovers,150000,Wypożyczenie,GB2,2021,1000000,850000
Josh Wilson-Esbrand,Coventry City,1000000,Wypożyczenie,GB2,2022,1000000,0
Luke McNally,Coventry City,900000,Wypożyczenie,GB2,2022,900000,0
Luke Cundle,Swansea City,800000,Wypożyczenie,GB2,2022,1000000,200000
Christ Tiehi,Wigan Athletic,800000,Wypożyczenie,GB2,2022,1000000,200000
Miguel Azeez,Wigan Athletic,800000,Wypożyczenie,GB2,2022,800000,0
Miguel Azeez,FC Portsmouth,500000,Wypożyczenie,GB3,2021,800000,300000
George Hirst,Blackburn Rovers,800000,Wypożyczenie,GB2,2022,800000,0
George Hirst,Ipswich Town,800000,Wypożyczenie,GB3,2022,800000,0
George Hirst,FC Portsmouth,800000,Wypożyczenie,GB3,2021,800000,0
George Hirst,Rotherham United,450000,Wypożyczenie,GB2,2020,800000,350000
Cédric Kipré,Cardiff City,800000,Wypożyczenie,GB2,2022,1000000,200000
Ethan Horvath,Luton Town,800000,Wypożyczenie,GB2,2022,1000000,200000
Leo Fuhr Hjelde,Rotherham United,800000,Wypożyczenie,GB2,2022,1000000,200000
Omar Rekik,Wigan Athletic,800000,Wypożyczenie,GB2,2022,600000,-200000
Scott High,Rotherham United,800000,Wypożyczenie,GB2,2022,900000,100000
Scott High,Shrewsbury Town,0,Wypożyczenie,GB3,2020,900000,900000
Charlie Goode,FC Blackpool,800000,Wypożyczenie,GB2,2022,800000,0
Charlie Goode,Sheffield United,1000000,Wypożyczenie,GB2,2021,800000,-200000
Charlie Goode,Northampton Town,100000,Wypożyczenie,GB4,2018,800000,700000
Bailey Wright,Rotherham United,700000,Wypożyczenie,GB2,2022,700000,0
Bailey Wright,AFC Sunderland,1000000,Wypożyczenie,GB3,2019,700000,-300000
Ellis Simms,AFC Sunderland,600000,Wypożyczenie,GB2,2022,4000000,3400000
Ellis Simms,FC Blackpool,0,Wypożyczenie,GB3,2020,4000000,4000000
Luke Mbete,Huddersfield Town,600000,Wypożyczenie,GB2,2022,2000000,1400000
Luke Mbete,Bolton Wanderers,2000000,Wypożyczenie,GB3,2022,2000000,0
Rarmani Edmonds-Green,Wigan Athletic,600000,Wypożyczenie,GB2,2022,500000,-100000
Rarmani Edmonds-Green,Rotherham United,500000,Wypożyczenie,GB3,2021,500000,0
Rarmani Edmonds-Green,Swindon Town,150000,Wypożyczenie,GB4,2019,500000,350000
Dion Sanderson,Birmingham City,600000,Wypożyczenie,GB2,2022,3000000,2400000
Dion Sanderson,Queens Park Rangers,300000,Wypożyczenie,GB2,2021,3000000,2700000
Dion Sanderson,Birmingham City,150000,Wypożyczenie,GB2,2021,3000000,2850000
Dion Sanderson,AFC Sunderland,150000,Wypożyczenie,GB3,2020,3000000,2850000
Dion Sanderson,Cardiff City,0,Wypożyczenie,GB2,2019,3000000,3000000
Lewis Fiorini,FC Blackpool,600000,Wypożyczenie,GB2,2022,1000000,400000
Lewis Fiorini,Lincoln City,400000,Wypożyczenie,GB3,2021,1000000,600000
Callum Doyle,Coventry City,600000,Wypożyczenie,GB2,2022,5000000,4400000
Callum Doyle,AFC Sunderland,0,Wypożyczenie,GB3,2021,5000000,5000000
Nathan Broadhead,Wigan Athletic,500000,Wypożyczenie,GB2,2022,500000,0
Nathan Broadhead,AFC Sunderland,500000,Wypożyczenie,GB3,2021,500000,0
Nathan Broadhead,Burton Albion,0,Wypożyczenie,GB3,2019,500000,500000
Joseph Hungbo,Huddersfield Town,450000,Wypożyczenie,GB2,2022,450000,0
Taylor Richards,Queens Park Rangers,400000,Wypożyczenie,GB2,2022,400000,0
Taylor Richards,Birmingham City,400000,Wypożyczenie,GB2,2021,400000,0
Taylor Richards,Doncaster Rovers,0,Wypożyczenie,GB3,2020,400000,400000
Harvey Vale,Hull City,400000,Wypożyczenie,GB2,2022,2000000,1600000
Fin Stevens,Swansea City,400000,Wypożyczenie,GB2,2022,400000,0
Matthew Lowton,Huddersfield Town,400000,Wypożyczenie,GB2,2022,400000,0
Harry Clarke,Stoke City,350000,Wypożyczenie,GB2,2022,600000,250000
Harry Clarke,Oldham Athletic,0,Wypożyczenie,GB4,2020,600000,600000
Matthew Sorinola,Swansea City,350000,Wypożyczenie,GB2,2022,800000,450000
Jordan Smith,Huddersfield Town,300000,Wypożyczenie,GB2,2022,300000,0
Jordan Smith,FC Barnsley,250000,Wypożyczenie,GB3,2018,300000,50000
Jordan Smith,Mansfield Town,250000,Wypożyczenie,GB4,2018,300000,50000
Kaine Kesler-Hayden,Huddersfield Town,300000,Wypożyczenie,GB2,2022,1000000,700000
Kaine Kesler-Hayden,Milton Keynes Dons,250000,Wypożyczenie,GB3,2021,1000000,750000
Kaine Kesler-Hayden,Swindon Town,250000,Wypożyczenie,GB4,2021,1000000,750000
Xavier Simons,Hull City,300000,Wypożyczenie,GB2,2022,500000,200000
Martyn Waghorn,Huddersfield Town,300000,Wypożyczenie,GB2,2022,300000,0
Emmanuel Longelo,Birmingham City,150000,Wypożyczenie,GB2,2022,800000,650000
Tyrese Fornah,FC Reading,0,Wypożyczenie,GB2,2022,700000,700000
Tyrese Fornah,Shrewsbury Town,0,Wypożyczenie,GB3,2021,700000,700000
Tyrese Fornah,Plymouth Argyle,0,Wypożyczenie,GB3,2020,700000,700000
Salah-Eddine Oulad M'Hand,Hull City,0,Wypożyczenie,GB2,2022,800000,800000
Thomas Cannon,Preston North End,0,Wypożyczenie,GB2,2022,3000000,3000000
Tayo Adaramola,Coventry City,0,Wypożyczenie,GB2,2022,1000000,1000000
Armstrong Oko-Flex,Swansea City,0,Wypożyczenie,GB2,2022,500000,500000
Shola Shoretire,Bolton Wanderers,4000000,Wypożyczenie,GB3,2022,4000000,0
Di'Shon Bernard,FC Portsmouth,3000000,Wypożyczenie,GB3,2022,3000000,0
Di'Shon Bernard,Hull City,1000000,Wypożyczenie,GB2,2021,3000000,2000000
Di'Shon Bernard,Salford City,1000000,Wypożyczenie,GB4,2020,3000000,2000000
Tom Edwards,FC Barnsley,2000000,Wypożyczenie,GB3,2022,1000000,-1000000
Tom Edwards,Fleetwood Town,1000000,Wypożyczenie,GB3,2020,1000000,0
Josh Koroma,FC Portsmouth,2000000,Wypożyczenie,GB3,2022,1000000,-1000000
Josh Koroma,Rotherham United,150000,Wypożyczenie,GB3,2019,1000000,850000
Steven Sessegnon,Charlton Athletic,1000000,Wypożyczenie,GB3,2022,700000,-300000
Steven Sessegnon,Plymouth Argyle,1000000,Wypożyczenie,GB3,2021,700000,-300000
Steven Sessegnon,Bristol City,2000000,Wypożyczenie,GB2,2020,700000,-1300000
Dan N'Lundulu,Cheltenham Town,1000000,Wypożyczenie,GB3,2022,1000000,0
Dan N'Lundulu,Bolton Wanderers,1000000,Wypożyczenie,GB3,2022,1000000,0
Dan N'Lundulu,Cheltenham Town,1000000,Wypożyczenie,GB3,2021,1000000,0
Dan N'Lundulu,Lincoln City,1000000,Wypożyczenie,GB3,2021,1000000,0
Mark McGuinness,Sheffield Wednesday,1000000,Wypożyczenie,GB3,2022,3000000,2000000
Mark McGuinness,Ipswich Town,0,Wypożyczenie,GB3,2020,3000000,3000000
Dynel Simeu,FC Morecambe,1000000,Wypożyczenie,GB3,2022,1000000,0
Dynel Simeu,Tranmere Rovers,1000000,Wypożyczenie,GB4,2022,1000000,0
Dynel Simeu,Carlisle United,1000000,Wypożyczenie,GB4,2021,1000000,0
Lewis Bate,Oxford United,1000000,Wypożyczenie,GB3,2022,1000000,0
Louie Barry,Milton Keynes Dons,1000000,Wypożyczenie,GB3,2022,1000000,0
Louie Barry,Salford City,1000000,Wypożyczenie,GB4,2022,1000000,0
Louie Barry,Ipswich Town,1000000,Wypożyczenie,GB3,2021,1000000,0
Louie Barry,Swindon Town,1000000,Wypożyczenie,GB4,2021,1000000,0
Sam Cosgrove,Plymouth Argyle,1000000,Wypożyczenie,GB3,2022,1000000,0
Sam Cosgrove,AFC Wimbledon,1000000,Wypożyczenie,GB3,2021,1000000,0
Sam Cosgrove,Shrewsbury Town,1000000,Wypożyczenie,GB3,2021,1000000,0
Morgan Whittaker,Plymouth Argyle,1000000,Wypożyczenie,GB3,2022,1000000,0
Morgan Whittaker,Lincoln City,1000000,Wypożyczenie,GB3,2021,1000000,0
Conor Bradley,Bolton Wanderers,1000000,Wypożyczenie,GB3,2022,1000000,0
Myles Peart-Harris,Forest Green Rovers,1000000,Wypożyczenie,GB3,2022,1000000,0
Tashan Oakley-Boothe,Lincoln City,900000,Wypożyczenie,GB3,2022,450000,-450000
Rekeem Harper,Exeter City,800000,Wypożyczenie,GB3,2022,800000,0
Rekeem Harper,Crewe Alexandra,2000000,Wypożyczenie,GB3,2021,800000,-1200000
Rekeem Harper,Birmingham City,2000000,Wypożyczenie,GB2,2020,800000,-1200000
Tyreece John-Jules,Ipswich Town,800000,Wypożyczenie,GB3,2022,800000,0
Tyreece John-Jules,FC Blackpool,0,Wypożyczenie,GB2,2021,800000,800000
Tyreece John-Jules,Sheffield Wednesday,700000,Wypożyczenie,GB3,2021,800000,100000
Tyreece John-Jules,Doncaster Rovers,0,Wypożyczenie,GB3,2020,800000,800000
Tyreece John-Jules,Lincoln City,0,Wypożyczenie,GB3,2019,800000,800000
Josh Martin,FC Barnsley,800000,Wypożyczenie,GB3,2022,800000,0
Josh Martin,Doncaster Rovers,1000000,Wypożyczenie,GB3,2021,800000,-200000
Josh Martin,Milton Keynes Dons,1000000,Wypożyczenie,GB3,2021,800000,-200000
Taylor Moore,Shrewsbury Town,800000,Wypożyczenie,GB3,2022,600000,-200000
Taylor Moore,FC Blackpool,1000000,Wypożyczenie,GB3,2019,600000,-400000
Taylor Moore,Southend United,500000,Wypożyczenie,GB3,2018,600000,100000
Henry Lawrence,Milton Keynes Dons,800000,Wypożyczenie,GB3,2022,800000,0
Henry Lawrence,AFC Wimbledon,0,Wypożyczenie,GB3,2021,800000,800000
Slobodan Tedic,FC Barnsley,750000,Wypożyczenie,GB3,2022,750000,0
Matty Taylor,Port Vale FC,600000,Wypożyczenie,GB3,2022,600000,0
Matty Taylor,Oxford United,750000,Wypożyczenie,GB3,2019,600000,-150000
Reece James,Sheffield Wednesday,600000,Wypożyczenie,GB3,2022,600000,0
Reece James,Sheffield Wednesday,600000,Wypożyczenie,GB3,2022,70000000,69400000
Reece James,Wigan Athletic,0,Wypożyczenie,GB2,2018,600000,600000
Reece James,Wigan Athletic,0,Wypożyczenie,GB2,2018,70000000,70000000
Charlie Savage,Forest Green Rovers,600000,Wypożyczenie,GB3,2022,600000,0
Alex Mighten,Sheffield Wednesday,600000,Wypożyczenie,GB3,2022,600000,0
Luke Plange,Lincoln City,600000,Wypożyczenie,GB3,2022,600000,0
Luke Plange,Derby County,0,Wypożyczenie,GB2,2021,600000,600000
Harvey White,Derby County,600000,Wypożyczenie,GB3,2022,600000,0
Harvey White,FC Portsmouth,0,Wypożyczenie,GB3,2020,600000,600000
Aden Flint,Sheffield Wednesday,600000,Wypożyczenie,GB3,2022,600000,0
Aden Flint,Sheffield Wednesday,3000000,Wypożyczenie,GB2,2020,600000,-2400000
Jordon Garrick,Lincoln City,600000,Wypożyczenie,GB3,2022,600000,0
Jordon Garrick,Plymouth Argyle,250000,Wypożyczenie,GB3,2021,600000,350000
Jordon Garrick,Swindon Town,250000,Wypożyczenie,GB3,2020,600000,350000
Jay Stansfield,Exeter City,500000,Wypożyczenie,GB3,2022,500000,0
Carl Winchester,Shrewsbury Town,500000,Wypożyczenie,GB3,2022,500000,0
Chem Campbell,Wycombe Wanderers,500000,Wypożyczenie,GB3,2022,500000,0
Luke Southwood,Cheltenham Town,500000,Wypożyczenie,GB3,2022,500000,0
Nathanael Ogbeta,Peterborough United,500000,Wypożyczenie,GB3,2022,500000,0
Josh Coburn,Bristol Rovers,500000,Wypożyczenie,GB3,2022,500000,0
Jesurun Rak-Sakyi,Charlton Athletic,500000,Wypożyczenie,GB3,2022,500000,0
Liam McCarron,Port Vale FC,500000,Wypożyczenie,GB3,2022,500000,0
Haydon Roberts,Derby County,500000,Wypożyczenie,GB3,2022,500000,0
Haydon Roberts,AFC Rochdale,0,Wypożyczenie,GB3,2020,500000,500000
Josh Griffiths,FC Portsmouth,500000,Wypożyczenie,GB3,2022,1000000,500000
Josh Griffiths,Lincoln City,500000,Wypożyczenie,GB3,2021,1000000,500000
Josh Griffiths,Cheltenham Town,0,Wypożyczenie,GB4,2020,1000000,1000000
Lewis Gibson,Bristol Rovers,500000,Wypożyczenie,GB3,2022,500000,0
Lewis Gibson,Sheffield Wednesday,500000,Wypożyczenie,GB3,2021,500000,0
Lewis Gibson,FC Reading,0,Wypożyczenie,GB2,2020,500000,500000
Lewis Gibson,Fleetwood Town,0,Wypożyczenie,GB3,2019,500000,500000
Tyler Onyango,Forest Green Rovers,450000,Wypożyczenie,GB3,2022,450000,0
Tyler Onyango,Burton Albion,200000,Wypożyczenie,GB3,2022,450000,250000
Charlie Kirk,Burton Albion,400000,Wypożyczenie,GB3,2022,400000,0
Charlie Kirk,FC Blackpool,500000,Wypożyczenie,GB2,2021,400000,-100000
Admiral Muskwe,Fleetwood Town,400000,Wypożyczenie,GB3,2022,300000,-100000
Admiral Muskwe,Wycombe Wanderers,100000,Wypożyczenie,GB2,2020,300000,200000
Admiral Muskwe,Swindon Town,100000,Wypożyczenie,GB4,2019,300000,200000
Bali Mumba,Plymouth Argyle,400000,Wypożyczenie,GB3,2022,400000,0
Bali Mumba,Peterborough United,500000,Wypożyczenie,GB2,2021,400000,-100000
Todd Kane,Charlton Athletic,400000,Wypożyczenie,GB3,2022,400000,0
Todd Kane,Hull City,1000000,Wypożyczenie,GB2,2018,400000,-600000
Anthony Stewart,Milton Keynes Dons,400000,Wypożyczenie,GB3,2022,400000,0
Max Watters,FC Barnsley,400000,Wypożyczenie,GB3,2022,400000,0
Max Watters,Milton Keynes Dons,150000,Wypożyczenie,GB3,2021,400000,250000
Owen Dale,FC Portsmouth,400000,Wypożyczenie,GB3,2022,400000,0
Owen Dale,FC Blackpool,0,Wypożyczenie,GB2,2021,400000,400000
Owen Beck,Bolton Wanderers,400000,Wypożyczenie,GB3,2022,400000,0
Jay Matete,Plymouth Argyle,400000,Wypożyczenie,GB3,2022,400000,0
Jay Matete,Grimsby Town,0,Wypożyczenie,GB4,2020,400000,400000
Jordan Amissah,Burton Albion,400000,Wypożyczenie,GB3,2022,400000,0
Steve Seddon,Cambridge United,350000,Wypożyczenie,GB3,2022,350000,0
Steve Seddon,AFC Wimbledon,150000,Wypożyczenie,GB3,2020,350000,200000
Steve Seddon,FC Portsmouth,150000,Wypożyczenie,GB3,2019,350000,200000
Steve Seddon,AFC Wimbledon,0,Wypożyczenie,GB3,2018,350000,350000
Steve Seddon,FC Stevenage,0,Wypożyczenie,GB4,2018,350000,350000
Dale Taylor,Burton Albion,350000,Wypożyczenie,GB3,2022,350000,0
Jamie Cumming,Milton Keynes Dons,300000,Wypożyczenie,GB3,2022,900000,600000
Jamie Cumming,Milton Keynes Dons,300000,Wypożyczenie,GB3,2021,900000,600000
Jamie Cumming,FC Gillingham,300000,Wypożyczenie,GB3,2021,900000,600000
Jamie Cumming,FC Stevenage,450000,Wypożyczenie,GB4,2020,900000,450000
Conor McGrandles,Cambridge United,300000,Wypożyczenie,GB3,2022,300000,0
Kyle Joseph,Oxford United,300000,Wypożyczenie,GB3,2022,300000,0
Kyle Joseph,Cheltenham Town,100000,Wypożyczenie,GB3,2021,300000,200000
Glen Rea,Cheltenham Town,300000,Wypożyczenie,GB3,2022,300000,0
Glen Rea,Wigan Athletic,600000,Wypożyczenie,GB3,2021,300000,-300000
Jasper Moon,Burton Albion,300000,Wypożyczenie,GB3,2022,300000,0
Ellery Balcombe,Bristol Rovers,300000,Wypożyczenie,GB3,2022,300000,0
Ellery Balcombe,Crawley Town,300000,Wypożyczenie,GB4,2022,300000,0
Ellery Balcombe,Burton Albion,300000,Wypożyczenie,GB3,2021,300000,0
Ellery Balcombe,Doncaster Rovers,300000,Wypożyczenie,GB3,2020,300000,0
Brandon Cooper,Forest Green Rovers,300000,Wypożyczenie,GB3,2022,300000,0
Brandon Cooper,Swindon Town,500000,Wypożyczenie,GB4,2021,300000,-200000
Brandon Cooper,Newport County,0,Wypożyczenie,GB4,2020,300000,300000
Liam Shaw,FC Morecambe,300000,Wypożyczenie,GB3,2022,300000,0
Lewis Dobbin,Derby County,300000,Wypożyczenie,GB3,2022,300000,0
Tyler Smith,Oxford United,300000,Wypożyczenie,GB3,2022,300000,0
Tyler Smith,Swindon Town,0,Wypożyczenie,GB3,2020,300000,300000
Tyler Smith,Bristol Rovers,0,Wypożyczenie,GB3,2019,300000,300000
Tyler Smith,AFC Rochdale,0,Wypożyczenie,GB3,2019,300000,300000
Tyler Smith,Doncaster Rovers,0,Wypożyczenie,GB3,2018,300000,300000
Mipo Odubeko,Port Vale FC,300000,Wypożyczenie,GB3,2022,300000,0
Mipo Odubeko,Huddersfield Town,250000,Wypożyczenie,GB2,2021,300000,50000
Mipo Odubeko,Doncaster Rovers,300000,Wypożyczenie,GB3,2021,300000,0
Brandon Fleming,Oxford United,300000,Wypożyczenie,GB3,2022,300000,0
Brandon Fleming,Bolton Wanderers,150000,Wypożyczenie,GB3,2019,300000,150000
Elliot Thorpe,Burton Albion,300000,Wypożyczenie,GB3,2022,250000,-50000
Nigel Lonwijk,Plymouth Argyle,300000,Wypożyczenie,GB3,2022,300000,0
Julien Da Costa,Shrewsbury Town,300000,Wypożyczenie,GB3,2022,300000,0
Matt Macey,FC Portsmouth,300000,Wypożyczenie,GB3,2022,300000,0
Matt Macey,Plymouth Argyle,500000,Wypożyczenie,GB3,2018,300000,-200000
Lamare Bogarde,Bristol Rovers,300000,Wypożyczenie,GB3,2022,300000,0
Harry Isted,FC Barnsley,250000,Wypożyczenie,GB3,2022,250000,0
Caleb Taylor,Cheltenham Town,250000,Wypożyczenie,GB3,2022,250000,0
Elkan Baggott,Cheltenham Town,250000,Wypożyczenie,GB3,2022,250000,0
Elkan Baggott,FC Gillingham,0,Wypożyczenie,GB4,2022,250000,250000
Sam Lavelle,Burton Albion,250000,Wypożyczenie,GB3,2022,250000,0
Carlos Mendes,Fleetwood Town,250000,Wypożyczenie,GB3,2022,250000,0
Caleb Watts,FC Morecambe,250000,Wypożyczenie,GB3,2022,250000,0
Caleb Watts,Crawley Town,250000,Wypożyczenie,GB4,2021,250000,0
Dane Scarlett,FC Portsmouth,250000,Wypożyczenie,GB3,2022,2000000,1750000
Jahmari Clarke,Forest Green Rovers,250000,Wypożyczenie,GB3,2022,250000,0
Sylvester Jasper,Bristol Rovers,250000,Wypożyczenie,GB3,2022,250000,0
Sylvester Jasper,Colchester United,250000,Wypożyczenie,GB4,2021,250000,0
Olamide Shodipo,Lincoln City,250000,Wypożyczenie,GB3,2022,250000,0
Olamide Shodipo,Sheffield Wednesday,200000,Wypożyczenie,GB3,2021,250000,50000
Olamide Shodipo,Oxford United,100000,Wypożyczenie,GB3,2020,250000,150000
Matt Penney,Charlton Athletic,250000,Wypożyczenie,GB3,2022,250000,0
Oliver Casey,Forest Green Rovers,250000,Wypożyczenie,GB3,2022,250000,0
Kieran Phillips,FC Morecambe,200000,Wypożyczenie,GB3,2022,300000,100000
Kieran Phillips,FC Walsall,200000,Wypożyczenie,GB4,2021,300000,100000
Kieran Phillips,Exeter City,200000,Wypożyczenie,GB4,2021,300000,100000
Jakub Stolarczyk,Fleetwood Town,200000,Wypożyczenie,GB3,2022,200000,0
Jakub Stolarczyk,Hartlepool United,200000,Wypożyczenie,GB4,2022,200000,0
Gassan Ahadme,Burton Albion,200000,Wypożyczenie,GB3,2022,200000,0
Gassan Ahadme,FC Portsmouth,50000,Wypożyczenie,GB3,2021,200000,150000
Paris Maghoma,Milton Keynes Dons,200000,Wypożyczenie,GB3,2022,200000,0
Paris Maghoma,AFC Wimbledon,200000,Wypożyczenie,GB4,2022,200000,0
Harvey Cartwright,Peterborough United,200000,Wypożyczenie,GB3,2022,200000,0
Harvey Cartwright,Wycombe Wanderers,200000,Wypożyczenie,GB3,2022,200000,0
Jack Stevens,Port Vale FC,200000,Wypożyczenie,GB3,2022,200000,0
Matty Virtue,Lincoln City,200000,Wypożyczenie,GB3,2022,200000,0
Daniel Butterworth,Port Vale FC,200000,Wypożyczenie,GB3,2022,200000,0
Daniel Butterworth,Fleetwood Town,200000,Wypożyczenie,GB3,2021,200000,0
Will Norris,Peterborough United,200000,Wypożyczenie,GB3,2022,200000,0
Will Norris,Ipswich Town,250000,Wypożyczenie,GB3,2019,200000,-50000
Christian Marques,Forest Green Rovers,200000,Wypożyczenie,GB3,2022,200000,0
Aaron Donnelly,Port Vale FC,200000,Wypożyczenie,GB3,2022,200000,0
Luke McGee,Derby County,200000,Wypożyczenie,GB3,2022,200000,0
Luke McGee,Bradford City,100000,Wypożyczenie,GB4,2019,200000,100000
Dennis Politic,Port Vale FC,200000,Wypożyczenie,GB3,2022,200000,0
Dennis Politic,Port Vale FC,0,Wypożyczenie,GB4,2021,200000,200000
Viljami Sinisalo,Burton Albion,200000,Wypożyczenie,GB3,2022,400000,200000
Bryan Fiabema,Forest Green Rovers,200000,Wypożyczenie,GB3,2022,200000,0
Jensen Weir,FC Morecambe,150000,Wypożyczenie,GB3,2022,350000,200000
Jensen Weir,Cambridge United,150000,Wypożyczenie,GB3,2021,350000,200000
Kgaogelo Chauke,Exeter City,150000,Wypożyczenie,GB3,2022,250000,100000
Ateef Konaté,Oxford United,150000,Wypożyczenie,GB3,2022,150000,0
Joshua Kayode,Milton Keynes Dons,150000,Wypożyczenie,GB3,2022,150000,0
Joshua Kayode,Carlisle United,50000,Wypożyczenie,GB4,2020,150000,100000
Joshua Kayode,Carlisle United,50000,Wypożyczenie,GB4,2019,150000,100000
Bobby Thomas,Bristol Rovers,150000,Wypożyczenie,GB3,2022,150000,0
Bobby Thomas,FC Barnsley,150000,Wypożyczenie,GB3,2022,150000,0
Bobby Thomas,AFC Barrow,200000,Wypożyczenie,GB4,2020,150000,-50000
Thierry Small,Port Vale FC,100000,Wypożyczenie,GB3,2022,1000000,900000
Jack Diamond,Lincoln City,100000,Wypożyczenie,GB3,2022,100000,0
Jack Diamond,Harrogate Town,0,Wypożyczenie,GB4,2021,100000,100000
Joe Pigott,FC Portsmouth,100000,Wypożyczenie,GB3,2022,500000,400000
Joseph Anang,Derby County,100000,Wypożyczenie,GB3,2022,100000,0
Joseph Anang,FC Stevenage,0,Wypożyczenie,GB4,2021,100000,100000
Corrie Ndaba,Burton Albion,100000,Wypożyczenie,GB3,2022,100000,0
Corrie Ndaba,Fleetwood Town,100000,Wypożyczenie,GB3,2022,100000,0
Corrie Ndaba,Salford City,50000,Wypożyczenie,GB4,2021,100000,50000
Aaron Pressley,Accrington Stanley,100000,Wypożyczenie,GB3,2022,100000,0
Aaron Pressley,AFC Wimbledon,100000,Wypożyczenie,GB3,2021,100000,0
Josh Austerfield,FC Morecambe,100000,Wypożyczenie,GB3,2022,100000,0
Josh Austerfield,Harrogate Town,100000,Wypożyczenie,GB4,2021,100000,0
Jökull Andrésson,Exeter City,100000,Wypożyczenie,GB3,2022,100000,0
Jökull Andrésson,FC Stevenage,100000,Wypożyczenie,GB4,2022,100000,0
Jökull Andrésson,FC Morecambe,100000,Wypożyczenie,GB3,2021,100000,0
Jökull Andrésson,Exeter City,100000,Wypożyczenie,GB4,2020,100000,0
Jökull Andrésson,FC Morecambe,100000,Wypożyczenie,GB4,2020,100000,0
Harry Boyes,Lincoln City,100000,Wypożyczenie,GB3,2022,100000,0
Harry Boyes,Forest Green Rovers,0,Wypożyczenie,GB3,2022,100000,100000
Killian Phillips,Shrewsbury Town,75000,Wypożyczenie,GB3,2022,75000,0
Harry Smith,Exeter City,50000,Wypożyczenie,GB3,2022,50000,0
Christian Saydee,Shrewsbury Town,50000,Wypożyczenie,GB3,2022,50000,0
Christian Saydee,Burton Albion,50000,Wypożyczenie,GB3,2021,50000,0
Lukas Jensen,Accrington Stanley,50000,Wypożyczenie,GB3,2022,200000,150000
Lukas Jensen,Carlisle United,25000,Wypożyczenie,GB4,2021,200000,175000
Lukas Jensen,Bolton Wanderers,25000,Wypożyczenie,GB4,2020,200000,175000
Doug Tharme,Accrington Stanley,50000,Wypożyczenie,GB3,2022,50000,0
Kabongo Tshimanga,Peterborough United,0,Wypożyczenie,GB3,2022,0,0
Lewis Warrington,Fleetwood Town,0,Wypożyczenie,GB3,2022,200000,200000
Lewis Warrington,Tranmere Rovers,0,Wypożyczenie,GB4,2021,200000,200000
Taylor Perry,Cheltenham Town,0,Wypożyczenie,GB3,2022,300000,300000
Taylor Perry,Cheltenham Town,0,Wypożyczenie,GB3,2021,300000,300000
Zac Ashworth,Burton Albion,0,Wypożyczenie,GB3,2022,0,0
Finn Azaz,Plymouth Argyle,0,Wypożyczenie,GB3,2022,400000,400000
Finn Azaz,Newport County,0,Wypożyczenie,GB4,2021,400000,400000
Finn Azaz,Cheltenham Town,0,Wypożyczenie,GB4,2020,400000,400000
Michael Mellon,FC Morecambe,0,Wypożyczenie,GB3,2022,0,0
Joe White,Exeter City,0,Wypożyczenie,GB3,2022,0,0
Joe White,Hartlepool United,0,Wypożyczenie,GB4,2021,0,0
James Taylor,Cheltenham Town,0,Wypożyczenie,GB3,2022,50000,50000
Tony Springett,Derby County,0,Wypożyczenie,GB3,2022,0,0
Kell Watts,Peterborough United,0,Wypożyczenie,GB3,2022,0,0
Kell Watts,Wigan Athletic,0,Wypożyczenie,GB3,2021,0,0
Kell Watts,Plymouth Argyle,0,Wypożyczenie,GB3,2020,0,0
Kell Watts,FC Stevenage,0,Wypożyczenie,GB4,2019,0,0
Kell Watts,Mansfield Town,0,Wypożyczenie,GB4,2019,0,0
William Osula,Derby County,0,Wypożyczenie,GB3,2022,150000,150000
Ziyad Larkeche,FC Barnsley,0,Wypożyczenie,GB3,2022,0,0
Daniel Oyegoke,Milton Keynes Dons,0,Wypożyczenie,GB3,2022,500000,500000
Robert Street,Shrewsbury Town,0,Wypożyczenie,GB3,2022,0,0
Robert Street,Newport County,0,Wypożyczenie,GB4,2021,0,0
Ryan Astley,Accrington Stanley,0,Wypożyczenie,GB3,2022,600000,600000
Jarell Quansah,Bristol Rovers,0,Wypożyczenie,GB3,2022,0,0
Nathan Butler-Oyedeji,Accrington Stanley,0,Wypożyczenie,GB3,2022,0,0
Carl Rushworth,Lincoln City,0,Wypożyczenie,GB3,2022,700000,700000
Carl Rushworth,FC Walsall,0,Wypożyczenie,GB4,2021,700000,700000
Quévin Castro,Burton Albion,0,Wypożyczenie,GB3,2022,0,0
Lucas Bergström,Peterborough United,0,Wypożyczenie,GB3,2022,250000,250000
Matty Longstaff,Colchester United,1000000,Wypożyczenie,GB4,2022,1000000,0
Matty Longstaff,Mansfield Town,2000000,Wypożyczenie,GB4,2021,1000000,-1000000
Arthur Okonkwo,Crewe Alexandra,1000000,Wypożyczenie,GB4,2022,1000000,0
Ethan Galbraith,Salford City,800000,Wypożyczenie,GB4,2022,800000,0
Ethan Galbraith,Doncaster Rovers,900000,Wypożyczenie,GB3,2021,800000,-100000
Luke Jephcott,Swindon Town,700000,Wypożyczenie,GB4,2022,700000,0
Aiden O'Brien,FC Gillingham,600000,Wypożyczenie,GB4,2022,600000,0
Ryan Schofield,Crawley Town,500000,Wypożyczenie,GB4,2022,500000,0
Ryan Schofield,Notts County,100000,Wypożyczenie,GB4,2018,500000,400000
Adam Lewis,Newport County,500000,Wypożyczenie,GB4,2022,500000,0
Adam Lewis,Plymouth Argyle,500000,Wypożyczenie,GB3,2020,500000,0
Toby Savin,FC Stevenage,450000,Wypożyczenie,GB4,2022,450000,0
Daryl Horgan,FC Stevenage,450000,Wypożyczenie,GB4,2022,450000,0
D'Mani Mellor,AFC Rochdale,450000,Wypożyczenie,GB4,2022,450000,0
D'Mani Mellor,Salford City,0,Wypożyczenie,GB4,2021,450000,450000
Dean Campbell,FC Stevenage,425000,Wypożyczenie,GB4,2022,425000,0
Paul Glatzel,Tranmere Rovers,400000,Wypożyczenie,GB4,2022,400000,0
Paul Glatzel,Tranmere Rovers,350000,Wypożyczenie,GB4,2021,400000,50000
D'Margio Wright-Phillips,Northampton Town,400000,Wypożyczenie,GB4,2022,400000,0
Diallang Jaiyesimi,AFC Wimbledon,400000,Wypożyczenie,GB4,2022,400000,0
Diallang Jaiyesimi,Swindon Town,0,Wypożyczenie,GB4,2019,400000,400000
Diallang Jaiyesimi,Yeovil Town,0,Wypożyczenie,GB4,2018,400000,400000
Tete Yengi,Northampton Town,400000,Wypożyczenie,GB4,2022,400000,0
Alex Gilbey,FC Stevenage,400000,Wypożyczenie,GB4,2022,400000,0
Jamie McCart,Leyton Orient,400000,Wypożyczenie,GB4,2022,400000,0
Logan Chalmers,Tranmere Rovers,375000,Wypożyczenie,GB4,2022,375000,0
Josh Eppiah,Northampton Town,350000,Wypożyczenie,GB4,2022,350000,0
Josh Eppiah,Northampton Town,350000,Wypożyczenie,GB4,2021,350000,0
Mathew Stevens,FC Walsall,350000,Wypożyczenie,GB4,2022,350000,0
Mathew Stevens,FC Stevenage,0,Wypożyczenie,GB4,2020,350000,350000
Teddy Jenks,Crawley Town,325000,Wypożyczenie,GB4,2022,325000,0
Jack Hamilton,Hartlepool United,325000,Wypożyczenie,GB4,2022,325000,0
Marc Leonard,Northampton Town,300000,Wypożyczenie,GB4,2022,300000,0
Christy Pym,Mansfield Town,300000,Wypożyczenie,GB4,2022,300000,0
Christy Pym,FC Stevenage,300000,Wypożyczenie,GB4,2021,300000,0
Dan Kemp,Hartlepool United,300000,Wypożyczenie,GB4,2022,300000,0
Dan Kemp,FC Blackpool,0,Wypożyczenie,GB3,2020,300000,300000
Dan Kemp,FC Stevenage,0,Wypożyczenie,GB4,2019,300000,300000
Kasey McAteer,AFC Wimbledon,300000,Wypożyczenie,GB4,2022,300000,0
Kasey McAteer,Forest Green Rovers,300000,Wypożyczenie,GB4,2021,300000,0
Clarke Oduor,Hartlepool United,300000,Wypożyczenie,GB4,2022,300000,0
Max Woltman,Doncaster Rovers,300000,Wypożyczenie,GB4,2022,300000,0
Danny Johnson,FC Walsall,300000,Wypożyczenie,GB4,2022,300000,0
Dara Costelloe,Bradford City,300000,Wypożyczenie,GB4,2022,300000,0
Romoney Crichlow,Bradford City,300000,Wypożyczenie,GB4,2022,300000,0
Romoney Crichlow,Plymouth Argyle,300000,Wypożyczenie,GB3,2021,300000,0
Romoney Crichlow,Swindon Town,300000,Wypożyczenie,GB4,2021,300000,0
Ashley Maynard-Brewer,FC Gillingham,300000,Wypożyczenie,GB4,2022,300000,0
Jack Stretton,Carlisle United,300000,Wypożyczenie,GB4,2022,300000,0
Conor Masterson,FC Gillingham,300000,Wypożyczenie,GB4,2022,300000,0
Conor Masterson,FC Gillingham,300000,Wypożyczenie,GB3,2021,300000,0
Conor Masterson,Cambridge United,300000,Wypożyczenie,GB3,2021,300000,0
Conor Masterson,Swindon Town,300000,Wypożyczenie,GB3,2020,300000,0
Regan Hendry,Tranmere Rovers,300000,Wypożyczenie,GB4,2022,300000,0
Kieran Sadlier,Leyton Orient,300000,Wypożyczenie,GB4,2022,300000,0
Matty Daly,Harrogate Town,250000,Wypożyczenie,GB4,2022,250000,0
Matty Daly,Bradford City,250000,Wypożyczenie,GB4,2021,250000,0
Matty Daly,Hartlepool United,250000,Wypożyczenie,GB4,2021,250000,0
David Ajiboye,Sutton United,250000,Wypożyczenie,GB4,2022,250000,0
Charlie Lakin,Doncaster Rovers,250000,Wypożyczenie,GB4,2022,250000,0
Charlie Lakin,FC Stevenage,100000,Wypożyczenie,GB4,2019,250000,150000
Hakeeb Adelakun,FC Gillingham,250000,Wypożyczenie,GB4,2022,250000,0
Hakeeb Adelakun,Hull City,400000,Wypożyczenie,GB3,2020,250000,-150000
Hakeeb Adelakun,Rotherham United,500000,Wypożyczenie,GB3,2019,250000,-250000
Dion Pereira,Bradford City,250000,Wypożyczenie,GB4,2022,250000,0
Dion Pereira,Bradford City,300000,Wypożyczenie,GB4,2021,250000,-50000
Daniel Adshead,AFC Rochdale,250000,Wypożyczenie,GB4,2022,250000,0
Daniel Adshead,FC Gillingham,200000,Wypożyczenie,GB3,2021,250000,50000
Saikou Janneh,AFC Wimbledon,250000,Wypożyczenie,GB4,2022,250000,0
Saikou Janneh,Shrewsbury Town,0,Wypożyczenie,GB3,2021,250000,250000
Saikou Janneh,Newport County,0,Wypożyczenie,GB4,2020,250000,250000
Dan Chesters,Colchester United,250000,Wypożyczenie,GB4,2022,250000,0
Keyendrah Simmonds,Grimsby Town,250000,Wypożyczenie,GB4,2022,250000,0
Scott Banks,Bradford City,250000,Wypożyczenie,GB4,2022,250000,0
Josh Reid,FC Stevenage,250000,Wypożyczenie,GB4,2022,250000,0
Kazeem Olaigbe,Harrogate Town,225000,Wypożyczenie,GB4,2022,225000,0
Caleb Chukwuemeka,Crawley Town,200000,Wypożyczenie,GB4,2022,200000,0
Lewis Richardson,Grimsby Town,200000,Wypożyczenie,GB4,2022,200000,0
Aaron Rowe,Stockport County,200000,Wypożyczenie,GB4,2022,200000,0
Alex Cairns,Hartlepool United,200000,Wypożyczenie,GB4,2022,200000,0
Alex Cairns,Salford City,200000,Wypożyczenie,GB4,2022,200000,0
Ed Turns,Leyton Orient,200000,Wypożyczenie,GB4,2022,200000,0
Charlie McNeill,Newport County,200000,Wypożyczenie,GB4,2022,200000,0
Rayhaan Tulloch,AFC Rochdale,200000,Wypożyczenie,GB4,2022,200000,0
Rayhaan Tulloch,Doncaster Rovers,0,Wypożyczenie,GB3,2020,200000,200000
Luke Robinson,Tranmere Rovers,200000,Wypożyczenie,GB4,2022,200000,0
Kwesi Appiah,Colchester United,200000,Wypożyczenie,GB4,2022,200000,0
Charlie Kelman,Leyton Orient,200000,Wypożyczenie,GB4,2022,200000,0
Charlie Kelman,FC Gillingham,200000,Wypożyczenie,GB3,2021,200000,0
Joe Grayson,Stockport County,175000,Wypożyczenie,GB4,2022,175000,0
Joe Grayson,Oxford United,0,Wypożyczenie,GB3,2020,175000,175000
Joe Grayson,Grimsby Town,0,Wypożyczenie,GB4,2018,175000,175000
Tom Eastman,Harrogate Town,150000,Wypożyczenie,GB4,2022,150000,0
Jonathan Tomkinson,FC Stevenage,150000,Wypożyczenie,GB4,2022,150000,0
Hayden Lindley,Newport County,150000,Wypożyczenie,GB4,2022,150000,0
Jackson Smith,FC Walsall,150000,Wypożyczenie,GB4,2022,150000,0
Idris El Mizouni,Leyton Orient,150000,Wypożyczenie,GB4,2022,150000,0
Idris El Mizouni,Grimsby Town,0,Wypożyczenie,GB4,2020,150000,150000
Idris El Mizouni,Cambridge United,0,Wypożyczenie,GB4,2020,150000,150000
Idris El Mizouni,Cambridge United,0,Wypożyczenie,GB4,2019,150000,150000
Jack Jenkins,Salford City,150000,Wypożyczenie,GB4,2022,150000,0
Femi Seriki,AFC Rochdale,150000,Wypożyczenie,GB4,2022,150000,0
Lachlan Brook,Crewe Alexandra,150000,Wypożyczenie,GB4,2022,150000,0
Bez Lubala,Colchester United,150000,Wypożyczenie,GB4,2022,150000,0
Bez Lubala,Northampton Town,100000,Wypożyczenie,GB4,2021,150000,50000
Ryan Finnigan,Crewe Alexandra,150000,Wypożyczenie,GB4,2022,150000,0
Ciaran Brennan,Swindon Town,150000,Wypożyczenie,GB4,2022,150000,0
George Lloyd,Grimsby Town,150000,Wypożyczenie,GB4,2022,150000,0
George Lloyd,Port Vale FC,0,Wypożyczenie,GB4,2021,150000,150000
Joe Tomlinson,Swindon Town,150000,Wypożyczenie,GB4,2022,150000,0
Joe Tomlinson,Swindon Town,100000,Wypożyczenie,GB4,2021,150000,50000
Jack Spong,Crawley Town,150000,Wypożyczenie,GB4,2022,150000,0
Sol Brynn,Swindon Town,150000,Wypożyczenie,GB4,2022,150000,0
Tolaji Bola,Bradford City,150000,Wypożyczenie,GB4,2022,150000,0
Tolaji Bola,AFC Rochdale,0,Wypożyczenie,GB3,2020,150000,150000
Matthew Dennis,Sutton United,150000,Wypożyczenie,GB4,2022,150000,0
Danny Grant,Harrogate Town,150000,Wypożyczenie,GB4,2022,150000,0
Ryley Towler,AFC Wimbledon,100000,Wypożyczenie,GB4,2022,100000,0
Matty Dolan,Hartlepool United,100000,Wypożyczenie,GB4,2022,100000,0
Jake Eastwood,AFC Rochdale,100000,Wypożyczenie,GB4,2022,100000,0
Jake Eastwood,FC Portsmouth,100000,Wypożyczenie,GB3,2021,100000,0
Jake Eastwood,Grimsby Town,100000,Wypożyczenie,GB4,2020,100000,0
Jake Eastwood,Scunthorpe United,100000,Wypożyczenie,GB4,2019,100000,0
Stuart Moore,Doncaster Rovers,100000,Wypożyczenie,GB4,2022,100000,0
Josh Neufville,Sutton United,100000,Wypożyczenie,GB4,2022,100000,0
Yann Songo'o,FC Walsall,100000,Wypożyczenie,GB4,2022,100000,0
Tyla Dickinson,Sutton United,100000,Wypożyczenie,GB4,2022,100000,0
Flynn Clarke,FC Walsall,100000,Wypożyczenie,GB4,2022,100000,0
Thomas Dickson-Peters,Grimsby Town,100000,Wypożyczenie,GB4,2022,100000,0
Thomas Dickson-Peters,FC Gillingham,100000,Wypożyczenie,GB3,2021,100000,0
Frazer Blake-Tracy,Swindon Town,100000,Wypożyczenie,GB4,2022,100000,0
Josh Coley,Harrogate Town,100000,Wypożyczenie,GB4,2022,100000,0
Armani Little,AFC Wimbledon,100000,Wypożyczenie,GB4,2022,100000,0
James Brown,Doncaster Rovers,100000,Wypożyczenie,GB4,2022,100000,0
James Brown,Doncaster Rovers,100000,Wypożyczenie,GB4,2022,325000,225000
James Brown,Stockport County,100000,Wypożyczenie,GB4,2022,100000,0
James Brown,Stockport County,100000,Wypożyczenie,GB4,2022,325000,225000
James Brown,Lincoln City,150000,Wypożyczenie,GB4,2018,100000,-50000
James Brown,Lincoln City,150000,Wypożyczenie,GB4,2018,325000,175000
Jon McCracken,FC Stevenage,100000,Wypożyczenie,GB4,2022,100000,0
Khanya Leshabela,Crewe Alexandra,100000,Wypożyczenie,GB4,2022,100000,0
Khanya Leshabela,Shrewsbury Town,100000,Wypożyczenie,GB3,2021,100000,0
Haji Mnoga,FC Gillingham,100000,Wypożyczenie,GB4,2022,100000,0
Charlie Owens,Colchester United,100000,Wypożyczenie,GB4,2022,100000,0
Charlie Owens,Wycombe Wanderers,0,Wypożyczenie,GB3,2018,100000,100000
Vitezslav Jaros,Stockport County,100000,Wypożyczenie,GB4,2022,100000,0
Aribim Pepple,Grimsby Town,75000,Wypożyczenie,GB4,2022,100000,25000
Jacob Chapman,Salford City,75000,Wypożyczenie,GB4,2022,75000,0
Robbie Willmott,FC Walsall,50000,Wypożyczenie,GB4,2022,50000,0
Robbie Willmott,Exeter City,50000,Wypożyczenie,GB4,2020,50000,0
Glenn Morris,FC Gillingham,50000,Wypożyczenie,GB4,2022,50000,0
Chanka Zimba,Newport County,50000,Wypożyczenie,GB4,2022,50000,0
Chanka Zimba,Northampton Town,50000,Wypożyczenie,GB4,2021,50000,0
Stephen Duke-McKenna,Leyton Orient,50000,Wypożyczenie,GB4,2022,50000,0
Charley Kendall,Sutton United,50000,Wypożyczenie,GB4,2022,50000,0
Kian Harratt,Bradford City,50000,Wypożyczenie,GB4,2022,50000,0
Kian Harratt,Port Vale FC,50000,Wypożyczenie,GB4,2021,50000,0
Kian Harratt,Harrogate Town,0,Wypożyczenie,GB4,2020,50000,50000
Sonny Hilton,Carlisle United,25000,Wypożyczenie,GB4,2022,25000,0
Matty Foulds,Harrogate Town,0,Wypożyczenie,GB4,2022,0,0
Sam Pearson,AFC Wimbledon,0,Wypożyczenie,GB4,2022,0,0
Scott Quigley,AFC Rochdale,0,Wypożyczenie,GB4,2022,0,0
Scott Quigley,Port Vale FC,0,Wypożyczenie,GB4,2018,0,0
Tristan Abrahams,FC Gillingham,0,Wypożyczenie,GB4,2022,0,0
Tristan Abrahams,Leyton Orient,150000,Wypożyczenie,GB4,2020,0,-150000
Tristan Abrahams,Yeovil Town,0,Wypożyczenie,GB4,2018,0,0
Tristan Abrahams,Exeter City,0,Wypożyczenie,GB4,2018,0,0
Duncan Idehen,Carlisle United,0,Wypożyczenie,GB4,2022,0,0
Jayden Wareham,Leyton Orient,0,Wypożyczenie,GB4,2022,0,0
Cieran Slicker,AFC Rochdale,0,Wypożyczenie,GB4,2022,0,0
Taye Ashby-Hammond,FC Stevenage,0,Wypożyczenie,GB4,2022,0,0
David Robson,Crawley Town,0,Wypożyczenie,GB4,2022,0,0
Danny Cashman,FC Walsall,0,Wypożyczenie,GB4,2022,0,0
Danny Cashman,AFC Rochdale,0,Wypożyczenie,GB4,2021,0,0
Jay Turner-Cooke,Tranmere Rovers,0,Wypożyczenie,GB4,2022,0,0
Riley Harbottle,Mansfield Town,0,Wypożyczenie,GB4,2022,0,0
Mikey O'Neill,Grimsby Town,0,Wypożyczenie,GB4,2022,0,0
Tayt-Lemar Trusty,Hartlepool United,0,Wypożyczenie,GB4,2022,0,0
Taylor Foran,Hartlepool United,0,Wypożyczenie,GB4,2022,0,0
Josh Andrews,Doncaster Rovers,0,Wypożyczenie,GB4,2022,0,0
Josh Andrews,AFC Rochdale,0,Wypożyczenie,GB4,2021,0,0
Josh Andrews,Harrogate Town,0,Wypożyczenie,GB4,2020,0,0
Nathan Moriah-Welsh,Newport County,0,Wypożyczenie,GB4,2022,0,0
Dylan Kadji,Swindon Town,0,Wypożyczenie,GB4,2022,0,0
Connor Wood,Colchester United,0,Wypożyczenie,GB4,2022,0,0
Rollin Menayese,Hartlepool United,0,Wypożyczenie,GB4,2022,0,0
Rollin Menayese,FC Walsall,0,Wypożyczenie,GB4,2021,0,0
Rollin Menayese,Grimsby Town,0,Wypożyczenie,GB4,2020,0,0
Ben Nelson,AFC Rochdale,0,Wypożyczenie,GB4,2022,0,0
Ben Nelson,Doncaster Rovers,0,Wypożyczenie,GB4,2022,0,0
John McAtee,Grimsby Town,0,Wypożyczenie,GB4,2022,0,0
Alfie McCalmont,Carlisle United,0,Wypożyczenie,GB4,2022,0,0
Alfie McCalmont,FC Morecambe,0,Wypożyczenie,GB3,2021,0,0
Alfie McCalmont,Oldham Athletic,0,Wypożyczenie,GB4,2020,0,0
Tom Smith,Colchester United,0,Wypożyczenie,GB4,2022,0,0
Joe Low,FC Walsall,0,Wypożyczenie,GB4,2022,0,0
Nathan Young-Coombes,AFC Wimbledon,0,Wypożyczenie,GB4,2022,0,0
Joe O'Shaughnessy,Bradford City,0,Wypożyczenie,GB4,2022,0,0
Liam Bennett,FC Walsall,0,Wypożyczenie,GB4,2022,0,0
Jake Young,AFC Barrow,0,Wypożyczenie,GB4,2022,0,0
Matthew Baker,Newport County,0,Wypożyczenie,GB4,2022,0,0
Giosue Bellagambi,Salford City,0,Wypożyczenie,GB4,2022,0,0
Mazeed Ogungbo,Crawley Town,0,Wypożyczenie,GB4,2022,0,0
Owen Dodgson,AFC Rochdale,0,Wypożyczenie,GB4,2022,0,0
Lorent Tolaj,Salford City,0,Wypożyczenie,GB4,2022,0,0
Lorent Tolaj,Cambridge United,0,Wypożyczenie,GB3,2021,0,0
James Balagizi,Crawley Town,0,Wypożyczenie,GB4,2022,0,0
Will Swan,Mansfield Town,0,Wypożyczenie,GB4,2022,0,0
Will Swan,Port Vale FC,0,Wypożyczenie,GB4,2020,0,0
Fin Back,Carlisle United,0,Wypożyczenie,GB4,2022,0,0
Brendan Kiernan,Grimsby Town,0,Wypożyczenie,GB4,2022,0,0
Jack Robinson,Carlisle United,0,Wypożyczenie,GB4,2022,0,0
Ryan Law,FC Gillingham,0,Wypożyczenie,GB4,2022,0,0
Andy Smith,Grimsby Town,0,Wypożyczenie,GB4,2022,0,0
Andy Smith,Salford City,0,Wypożyczenie,GB4,2021,0,0
Jaheim Headley,Harrogate Town,0,Wypożyczenie,GB4,2022,0,0
Ben Barclay,Carlisle United,0,Wypożyczenie,GB4,2022,0,0
Ben Barclay,Notts County,0,Wypożyczenie,GB4,2018,0,0
Saxon Earley,FC Stevenage,0,Wypożyczenie,GB4,2022,0,0
Todd Miller,Doncaster Rovers,0,Wypożyczenie,GB4,2022,0,0
James Beadle,Crewe Alexandra,0,Wypożyczenie,GB4,2022,0,0
Sam McClelland,AFC Barrow,0,Wypożyczenie,GB4,2022,0,0
Thierry Nevers,Newport County,0,Wypożyczenie,GB4,2022,0,0
Thierry Nevers,Bradford City,0,Wypożyczenie,GB4,2022,0,0
Douglas James-Taylor,FC Walsall,0,Wypożyczenie,GB4,2022,0,0
Tyreik Wright,Bradford City,0,Wypożyczenie,GB4,2022,0,0
Tyreik Wright,Colchester United,0,Wypożyczenie,GB4,2021,0,0
Tyreik Wright,Salford City,0,Wypożyczenie,GB4,2021,0,0
Tyreik Wright,FC Walsall,0,Wypożyczenie,GB4,2020,0,0
Tom Fellows,Crawley Town,0,Wypożyczenie,GB4,2022,0,0
Kieron Bowie,Northampton Town,0,Wypożyczenie,GB4,2022,0,0
Lewis Richards,Harrogate Town,0,Wypożyczenie,GB4,2022,0,0
Lewis Richards,Harrogate Town,0,Wypożyczenie,GB4,2021,0,0
Sean Robertson,Crewe Alexandra,0,Wypożyczenie,GB4,2022,0,0
Harrison Neal,AFC Barrow,0,Wypożyczenie,GB4,2022,0,0
Calum Kavanagh,Newport County,0,Wypożyczenie,GB4,2022,0,0
Calum Kavanagh,Harrogate Town,0,Wypożyczenie,GB4,2021,0,0
Eli King,Crewe Alexandra,0,Wypożyczenie,GB4,2022,0,0
John-Kymani Gordon,Carlisle United,0,Wypożyczenie,GB4,2022,0,0
Ellis Taylor,Hartlepool United,0,Wypożyczenie,GB4,2022,0,0
Kyle Hudlin,AFC Wimbledon,0,Wypożyczenie,GB4,2022,0,0
Todd Cantwell,AFC Bournemouth,20000000,Wypożyczenie,GB2,2021,8000000,-12000000
Abdallah Sima,Stoke City,11000000,Wypożyczenie,GB2,2021,7000000,-4000000
Freddie Woodman,AFC Bournemouth,10000000,Wypożyczenie,GB2,2021,6000000,-4000000
Freddie Woodman,Swansea City,3000000,Wypożyczenie,GB2,2020,6000000,3000000
Freddie Woodman,Swansea City,500000,Wypożyczenie,GB2,2019,6000000,5500000
Neco Williams,FC Fulham,8000000,Wypożyczenie,GB2,2021,18000000,10000000
Nathaniel Phillips,AFC Bournemouth,8000000,Wypożyczenie,GB2,2021,6000000,-2000000
Filip Uremovic,Sheffield United,7000000,Wypożyczenie,GB2,2021,2000000,-5000000
Morgan Gibbs-White,Sheffield United,7000000,Wypożyczenie,GB2,2021,30000000,23000000
Morgan Gibbs-White,Swansea City,7000000,Wypożyczenie,GB2,2020,30000000,23000000
Andraz Sporar,FC Middlesbrough,5000000,Wypożyczenie,GB2,2021,5000000,0
Hannes Wolf,Swansea City,5000000,Wypożyczenie,GB2,2021,4000000,-1000000
Marcus Forss,Hull City,4000000,Wypożyczenie,GB2,2021,3000000,-1000000
Marcus Forss,AFC Wimbledon,150000,Wypożyczenie,GB3,2019,3000000,2850000
Andre Gray,Queens Park Rangers,4000000,Wypożyczenie,GB2,2021,2000000,-2000000
Tahith Chong,Birmingham City,4000000,Wypożyczenie,GB2,2021,3000000,-1000000
Josh Maja,Stoke City,4000000,Wypożyczenie,GB2,2021,4000000,0
Folarin Balogun,FC Middlesbrough,4000000,Wypożyczenie,GB2,2021,25000000,21000000
James Léa Siliki,FC Middlesbrough,4000000,Wypożyczenie,GB2,2021,1000000,-3000000
James Garner,Nottingham Forest,4000000,Wypożyczenie,GB2,2021,14000000,10000000
James Garner,Nottingham Forest,3000000,Wypożyczenie,GB2,2020,14000000,11000000
James Garner,FC Watford,2000000,Wypożyczenie,GB2,2020,14000000,12000000
Deyovaisio Zeefuik,Blackburn Rovers,3000000,Wypożyczenie,GB2,2021,1000000,-2000000
Liam Moore,Stoke City,3000000,Wypożyczenie,GB2,2021,1000000,-2000000
Conor Hourihane,Sheffield United,3000000,Wypożyczenie,GB2,2021,1000000,-2000000
Conor Hourihane,Swansea City,6000000,Wypożyczenie,GB2,2020,1000000,-5000000
Sam McCallum,Queens Park Rangers,3000000,Wypożyczenie,GB2,2021,3000000,0
Sam McCallum,Coventry City,750000,Wypożyczenie,GB2,2020,3000000,2250000
Sam McCallum,Coventry City,0,Wypożyczenie,GB3,2019,3000000,3000000
Danny Drinkwater,FC Reading,3000000,Wypożyczenie,GB2,2021,400000,-2600000
Allahyar Sayyadmanesh,Hull City,3000000,Wypożyczenie,GB2,2021,4000000,1000000
Robin Olsen,Sheffield United,3000000,Wypożyczenie,GB2,2021,2000000,-1000000
Philip Zinckernagel,Nottingham Forest,3000000,Wypożyczenie,GB2,2021,3000000,0
Josh Murphy,Preston North End,3000000,Wypożyczenie,GB2,2021,1000000,-2000000
Ben Davies,Sheffield United,3000000,Wypożyczenie,GB2,2021,3000000,0
Max Lowe,Nottingham Forest,3000000,Wypożyczenie,GB2,2021,3000000,0
Sheyi Ojo,FC Millwall,3000000,Wypożyczenie,GB2,2021,1000000,-2000000
Sheyi Ojo,Cardiff City,1000000,Wypożyczenie,GB2,2020,1000000,0
Leo Östigard,Stoke City,3000000,Wypożyczenie,GB2,2021,7000000,4000000
Leo Östigard,Coventry City,2000000,Wypożyczenie,GB2,2020,7000000,5000000
Matt Clarke,West Bromwich Albion,3000000,Wypożyczenie,GB2,2021,4000000,1000000
Matt Clarke,Derby County,2000000,Wypożyczenie,GB2,2020,4000000,2000000
Matt Clarke,Derby County,200000,Wypożyczenie,GB2,2019,4000000,3800000
Jan Paul van Hecke,Blackburn Rovers,2000000,Wypożyczenie,GB2,2021,4000000,2000000
Onel Hernández,FC Middlesbrough,2000000,Wypożyczenie,GB2,2021,1000000,-1000000
Onel Hernández,Birmingham City,1000000,Wypożyczenie,GB2,2021,1000000,0
Romaine Sawyers,Stoke City,2000000,Wypożyczenie,GB2,2021,1000000,-1000000
Jake Clarke-Salter,Coventry City,2000000,Wypożyczenie,GB2,2021,2000000,0
Jake Clarke-Salter,Birmingham City,2000000,Wypożyczenie,GB2,2020,2000000,0
Jake Clarke-Salter,Birmingham City,2000000,Wypożyczenie,GB2,2019,2000000,0
Djed Spence,Nottingham Forest,2000000,Wypożyczenie,GB2,2021,13000000,11000000
Jordan Hugill,West Bromwich Albion,2000000,Wypożyczenie,GB2,2021,900000,-1100000
Jordan Hugill,Cardiff City,1000000,Wypożyczenie,GB2,2021,900000,-100000
Jordan Hugill,Queens Park Rangers,6000000,Wypożyczenie,GB2,2019,900000,-5100000
Jordan Hugill,FC Middlesbrough,8000000,Wypożyczenie,GB2,2018,900000,-7100000
Teden Mengi,Birmingham City,2000000,Wypożyczenie,GB2,2021,2000000,0
Teden Mengi,Derby County,1000000,Wypożyczenie,GB2,2020,2000000,1000000
Amine Bassi,FC Barnsley,1000000,Wypożyczenie,GB2,2021,1000000,0
Benik Afobe,FC Millwall,1000000,Wypożyczenie,GB2,2021,1000000,0
Benik Afobe,Bristol City,8000000,Wypożyczenie,GB2,2019,1000000,-7000000
Benik Afobe,Stoke City,10000000,Wypożyczenie,GB2,2018,1000000,-9000000
Luke Freeman,FC Millwall,1000000,Wypożyczenie,GB2,2021,900000,-100000
Luke Freeman,Nottingham Forest,2000000,Wypożyczenie,GB2,2020,900000,-1100000
Jordi Osei-Tutu,Nottingham Forest,1000000,Wypożyczenie,GB2,2021,1000000,0
Jordi Osei-Tutu,Rotherham United,1000000,Wypożyczenie,GB3,2021,1000000,0
Jordi Osei-Tutu,Cardiff City,1000000,Wypożyczenie,GB2,2020,1000000,0
Hayden Coulson,Peterborough United,1000000,Wypożyczenie,GB2,2021,700000,-300000
Hayden Coulson,Ipswich Town,1000000,Wypożyczenie,GB3,2021,700000,-300000
Hayden Coulson,Cambridge United,100000,Wypożyczenie,GB4,2018,700000,600000
Daniel Iversen,Preston North End,1000000,Wypożyczenie,GB2,2021,2000000,1000000
Daniel Iversen,Preston North End,600000,Wypożyczenie,GB2,2020,2000000,1400000
Daniel Iversen,Rotherham United,500000,Wypożyczenie,GB3,2019,2000000,1500000
Daniel Iversen,Oldham Athletic,50000,Wypożyczenie,GB4,2018,2000000,1950000
Matt Smith,Hull City,1000000,Wypożyczenie,GB2,2021,600000,-400000
Matt Smith,Hull City,1000000,Wypożyczenie,GB2,2021,350000,-650000
Matt Smith,Doncaster Rovers,0,Wypożyczenie,GB3,2021,600000,600000
Matt Smith,Doncaster Rovers,0,Wypożyczenie,GB3,2021,350000,350000
Matt Smith,Doncaster Rovers,900000,Wypożyczenie,GB3,2020,600000,-300000
Matt Smith,Doncaster Rovers,900000,Wypożyczenie,GB3,2020,350000,-550000
Matt Smith,Charlton Athletic,0,Wypożyczenie,GB3,2020,600000,600000
Matt Smith,Charlton Athletic,0,Wypożyczenie,GB3,2020,350000,350000
Matt Smith,Swindon Town,0,Wypożyczenie,GB3,2020,600000,600000
Matt Smith,Swindon Town,0,Wypożyczenie,GB3,2020,350000,350000
Matt Smith,Queens Park Rangers,1000000,Wypożyczenie,GB2,2019,600000,-400000
Matt Smith,Queens Park Rangers,1000000,Wypożyczenie,GB2,2019,350000,-650000
Matt Smith,Charlton Athletic,1000000,Wypożyczenie,GB2,2019,600000,-400000
Matt Smith,Charlton Athletic,1000000,Wypożyczenie,GB2,2019,350000,-650000
Tom Ince,FC Reading,1000000,Wypożyczenie,GB2,2021,1000000,0
Tom Ince,Luton Town,2000000,Wypożyczenie,GB2,2020,1000000,-1000000
Rémy Vita,FC Barnsley,1000000,Wypożyczenie,GB2,2021,800000,-200000
Jayson Molumby,West Bromwich Albion,1000000,Wypożyczenie,GB2,2021,2000000,1000000
Jayson Molumby,Preston North End,900000,Wypożyczenie,GB2,2020,2000000,1100000
Jayson Molumby,FC Millwall,0,Wypożyczenie,GB2,2019,2000000,2000000
Cyrus Christie,Swansea City,1000000,Wypożyczenie,GB2,2021,1000000,0
Cyrus Christie,Nottingham Forest,1000000,Wypożyczenie,GB2,2020,1000000,0
Uche Ikpeazu,Cardiff City,800000,Wypożyczenie,GB2,2021,700000,-100000
Leif Davis,AFC Bournemouth,800000,Wypożyczenie,GB2,2021,800000,0
Jed Steer,Luton Town,800000,Wypożyczenie,GB2,2021,600000,-200000
Jed Steer,Charlton Athletic,500000,Wypożyczenie,GB3,2018,600000,100000
Alfie Doughty,Cardiff City,700000,Wypożyczenie,GB2,2021,1000000,300000
Lyle Taylor,Birmingham City,700000,Wypożyczenie,GB2,2021,350000,-350000
Juan Familia-Castillo,Birmingham City,700000,Wypożyczenie,GB2,2021,500000,-200000
Juan Familia-Castillo,Charlton Athletic,500000,Wypożyczenie,GB3,2021,500000,0
Tom Dele-Bashiru,FC Reading,700000,Wypożyczenie,GB2,2021,2000000,1300000
Matt Ingram,Luton Town,600000,Wypożyczenie,GB2,2021,1000000,400000
Matt Ingram,Wycombe Wanderers,250000,Wypożyczenie,GB3,2018,1000000,750000
Karl Hein,FC Reading,450000,Wypożyczenie,GB2,2021,1000000,550000
Claudio Gomes,FC Barnsley,450000,Wypożyczenie,GB2,2021,1000000,550000
Liam Walsh,Hull City,400000,Wypożyczenie,GB2,2021,350000,-50000
Liam Walsh,Coventry City,800000,Wypożyczenie,GB3,2019,350000,-450000
Finley Burns,Swansea City,300000,Wypożyczenie,GB2,2021,300000,0
Nathan Baxter,Hull City,300000,Wypożyczenie,GB2,2021,600000,300000
Nathan Baxter,Accrington Stanley,75000,Wypożyczenie,GB3,2020,600000,525000
Nathan Baxter,Yeovil Town,0,Wypożyczenie,GB4,2018,600000,600000
Steven Benda,Peterborough United,250000,Wypożyczenie,GB2,2021,400000,150000
Steven Benda,Swindon Town,100000,Wypożyczenie,GB4,2019,400000,300000
Reece Brown,Peterborough United,250000,Wypożyczenie,GB2,2021,250000,0
Reece Brown,Peterborough United,150000,Wypożyczenie,GB3,2020,250000,100000
Reece Brown,Peterborough United,150000,Wypożyczenie,GB3,2019,250000,100000
Alex Palmer,Luton Town,250000,Wypożyczenie,GB2,2021,500000,250000
Alex Palmer,Lincoln City,0,Wypożyczenie,GB3,2020,500000,500000
Alex Palmer,Plymouth Argyle,0,Wypożyczenie,GB4,2019,500000,500000
Alex Palmer,Notts County,0,Wypożyczenie,GB4,2018,500000,500000
Alex Palmer,Oldham Athletic,0,Wypożyczenie,GB4,2018,500000,500000
Leighton Clarkson,Blackburn Rovers,150000,Wypożyczenie,GB2,2021,800000,650000
Ryan Wintle,FC Blackpool,50000,Wypożyczenie,GB2,2021,3000000,2950000
Ryan Longman,Hull City,0,Wypożyczenie,GB2,2021,2000000,2000000
Ryan Longman,AFC Wimbledon,0,Wypożyczenie,GB3,2020,2000000,2000000
Callum Morton,Peterborough United,0,Wypożyczenie,GB2,2021,300000,300000
Callum Morton,Fleetwood Town,0,Wypożyczenie,GB3,2021,300000,300000
Callum Morton,Lincoln City,0,Wypożyczenie,GB3,2020,300000,300000
Callum Morton,Northampton Town,0,Wypożyczenie,GB4,2019,300000,300000
Levi Colwill,Huddersfield Town,0,Wypożyczenie,GB2,2021,16000000,16000000
Daniel Ballard,FC Millwall,0,Wypożyczenie,GB2,2021,2000000,2000000
Daniel Ballard,FC Blackpool,0,Wypożyczenie,GB3,2020,2000000,2000000
Daniel Ballard,Swindon Town,0,Wypożyczenie,GB4,2019,2000000,2000000
Jack Clarke,AFC Sunderland,5000000,Wypożyczenie,GB3,2021,8000000,3000000
Jack Clarke,Stoke City,5000000,Wypożyczenie,GB2,2020,8000000,3000000
Jack Clarke,Leeds United,6000000,Wypożyczenie,GB2,2019,8000000,2000000
Jack Clarke,Queens Park Rangers,6000000,Wypożyczenie,GB2,2019,8000000,2000000
Harlee Dean,Sheffield Wednesday,2000000,Wypożyczenie,GB3,2021,600000,-1400000
Macauley Bonne,Ipswich Town,2000000,Wypożyczenie,GB3,2021,800000,-1200000
Harry Arter,Charlton Athletic,2000000,Wypożyczenie,GB3,2021,600000,-1400000
Harry Arter,FC Fulham,7000000,Wypożyczenie,GB2,2019,600000,-6400000
Mahlon Romeo,FC Portsmouth,2000000,Wypożyczenie,GB3,2021,2000000,0
Lewis Wing,Sheffield Wednesday,2000000,Wypożyczenie,GB3,2021,600000,-1400000
Lewis Wing,Rotherham United,2000000,Wypożyczenie,GB2,2020,600000,-1400000
Leon Dajaku,AFC Sunderland,1000000,Wypożyczenie,GB3,2021,900000,-100000
Jordan Storey,Sheffield Wednesday,1000000,Wypożyczenie,GB3,2021,3000000,2000000
Jonathan Leko,Charlton Athletic,1000000,Wypożyczenie,GB3,2021,600000,-400000
Jonathan Leko,Charlton Athletic,1000000,Wypożyczenie,GB2,2019,600000,-400000
Pontus Dahlberg,FC Gillingham,1000000,Wypożyczenie,GB3,2021,1000000,0
Pontus Dahlberg,Doncaster Rovers,1000000,Wypożyczenie,GB3,2021,1000000,0
Will Grigg,Rotherham United,1000000,Wypożyczenie,GB3,2021,600000,-400000
Will Grigg,Milton Keynes Dons,1000000,Wypożyczenie,GB3,2020,600000,-400000
Frederik Alves,AFC Sunderland,1000000,Wypożyczenie,GB3,2021,600000,-400000
Daniel Jebbison,Burton Albion,1000000,Wypożyczenie,GB3,2021,1000000,0
Bailey Peacock-Farrell,Sheffield Wednesday,1000000,Wypożyczenie,GB3,2021,900000,-100000
Tyreeq Bakinson,Ipswich Town,1000000,Wypożyczenie,GB3,2021,700000,-300000
Tyreeq Bakinson,Plymouth Argyle,250000,Wypożyczenie,GB4,2019,700000,450000
Tyreeq Bakinson,Newport County,0,Wypożyczenie,GB4,2018,700000,700000
Dominic Thompson,Ipswich Town,800000,Wypożyczenie,GB3,2021,1000000,200000
Dominic Thompson,Swindon Town,400000,Wypożyczenie,GB3,2020,1000000,600000
Gavin Whyte,Oxford United,800000,Wypożyczenie,GB3,2021,600000,-200000
Gavin Whyte,Hull City,1000000,Wypożyczenie,GB3,2020,600000,-400000
Christian Walton,Ipswich Town,800000,Wypożyczenie,GB3,2021,800000,0
Christian Walton,Blackburn Rovers,1000000,Wypożyczenie,GB2,2019,800000,-200000
Christian Walton,Wigan Athletic,250000,Wypożyczenie,GB2,2018,800000,550000
Herbie Kane,Oxford United,700000,Wypożyczenie,GB3,2021,800000,100000
Herbie Kane,Hull City,250000,Wypożyczenie,GB2,2019,800000,550000
Herbie Kane,Doncaster Rovers,0,Wypożyczenie,GB3,2018,800000,800000
Tom Bayliss,Wigan Athletic,700000,Wypożyczenie,GB3,2021,350000,-350000
Ron-Thorben Hoffmann,AFC Sunderland,600000,Wypożyczenie,GB3,2021,400000,-200000
Xavier Amaechi,Bolton Wanderers,600000,Wypożyczenie,GB3,2021,500000,-100000
Elliot Lee,Charlton Athletic,600000,Wypożyczenie,GB3,2021,0,-600000
Elliot Lee,Oxford United,900000,Wypożyczenie,GB3,2020,0,-900000
Florian Kamberi,Sheffield Wednesday,550000,Wypożyczenie,GB3,2021,450000,-100000
Jacob Maddox,Burton Albion,500000,Wypożyczenie,GB3,2021,500000,0
Jacob Maddox,Tranmere Rovers,0,Wypożyczenie,GB3,2019,500000,500000
Jacob Maddox,Cheltenham Town,0,Wypożyczenie,GB4,2018,500000,500000
Tyler Walker,FC Portsmouth,500000,Wypożyczenie,GB3,2021,300000,-200000
Tyler Walker,Lincoln City,250000,Wypożyczenie,GB3,2019,300000,50000
Tyler Walker,Mansfield Town,250000,Wypożyczenie,GB4,2018,300000,50000
Jacob Bedeau,FC Morecambe,450000,Wypożyczenie,GB3,2021,450000,0
Ciaron Brown,Oxford United,400000,Wypożyczenie,GB3,2021,300000,-100000
Josh Harrop,Fleetwood Town,400000,Wypożyczenie,GB3,2021,250000,-150000
Josh Harrop,Ipswich Town,700000,Wypożyczenie,GB3,2020,250000,-450000
Harry Chapman,Burton Albion,400000,Wypożyczenie,GB3,2021,400000,0
Harry Chapman,Shrewsbury Town,300000,Wypożyczenie,GB3,2020,400000,100000
Ethan Robson,Milton Keynes Dons,400000,Wypożyczenie,GB3,2021,300000,-100000
Ethan Robson,Grimsby Town,500000,Wypożyczenie,GB4,2019,300000,-200000
Trevor Carson,FC Morecambe,350000,Wypożyczenie,GB3,2021,350000,0
Jordan Thorniley,Oxford United,300000,Wypożyczenie,GB3,2021,700000,400000
Tomas Holy,Cambridge United,300000,Wypożyczenie,GB3,2021,300000,0
Tomas Holy,Port Vale FC,300000,Wypożyczenie,GB4,2021,300000,0
Liam Cullen,Lincoln City,300000,Wypożyczenie,GB3,2021,1000000,700000
Joel Mumbongo,Accrington Stanley,300000,Wypożyczenie,GB3,2021,300000,0
Mattie Pollock,Cheltenham Town,250000,Wypożyczenie,GB3,2021,300000,50000
Kayne Ramsay,Crewe Alexandra,250000,Wypożyczenie,GB3,2021,250000,0
Kayne Ramsay,Shrewsbury Town,0,Wypożyczenie,GB3,2019,250000,250000
Ryan Broom,Plymouth Argyle,250000,Wypożyczenie,GB3,2021,350000,100000
Ryan Broom,Burton Albion,0,Wypożyczenie,GB3,2020,350000,350000
Matej Kovar,Burton Albion,250000,Wypożyczenie,GB3,2021,900000,650000
Matej Kovar,Swindon Town,250000,Wypożyczenie,GB3,2020,900000,650000
Hayden Carter,FC Portsmouth,250000,Wypożyczenie,GB3,2021,800000,550000
Hayden Carter,Burton Albion,150000,Wypożyczenie,GB3,2020,800000,650000
Connal Trueman,Oxford United,200000,Wypożyczenie,GB3,2021,200000,0
Connal Trueman,AFC Wimbledon,250000,Wypożyczenie,GB3,2020,200000,-50000
Connal Trueman,Swindon Town,250000,Wypożyczenie,GB3,2020,200000,-50000
Nile John,Charlton Athletic,200000,Wypożyczenie,GB3,2021,400000,200000
Peter Kioso,Milton Keynes Dons,200000,Wypożyczenie,GB3,2021,300000,100000
Peter Kioso,Northampton Town,100000,Wypożyczenie,GB3,2020,300000,200000
Peter Kioso,Bolton Wanderers,100000,Wypożyczenie,GB4,2020,300000,200000
Rodrigo Vilca,Doncaster Rovers,200000,Wypożyczenie,GB3,2021,350000,150000
Dapo Mebude,AFC Wimbledon,200000,Wypożyczenie,GB3,2021,300000,100000
Marcel Lewis,Accrington Stanley,150000,Wypożyczenie,GB3,2021,150000,0
Curtis Tilt,Wigan Athletic,150000,Wypożyczenie,GB3,2021,400000,250000
Curtis Tilt,Wigan Athletic,100000,Wypożyczenie,GB3,2020,400000,300000
Zak Jules,Fleetwood Town,100000,Wypożyczenie,GB3,2021,150000,50000
Christian Norton,Cheltenham Town,100000,Wypożyczenie,GB3,2021,100000,0
Akin Famewo,Charlton Athletic,100000,Wypożyczenie,GB3,2021,250000,150000
Akin Famewo,Charlton Athletic,25000,Wypożyczenie,GB3,2020,250000,225000
Akin Famewo,Grimsby Town,25000,Wypożyczenie,GB4,2018,250000,225000
Daniel Phillips,FC Gillingham,100000,Wypożyczenie,GB3,2021,100000,0
Adam Phillips,FC Morecambe,75000,Wypożyczenie,GB3,2021,150000,75000
Adam Phillips,Accrington Stanley,75000,Wypożyczenie,GB3,2020,150000,75000
Adam Phillips,FC Morecambe,75000,Wypożyczenie,GB4,2020,150000,75000
Adam Phillips,FC Morecambe,75000,Wypożyczenie,GB4,2019,150000,75000
Josh McPake,FC Morecambe,75000,Wypożyczenie,GB3,2021,125000,50000
Josh McPake,Tranmere Rovers,75000,Wypożyczenie,GB4,2021,125000,50000
Josh McPake,Harrogate Town,75000,Wypożyczenie,GB4,2020,125000,50000
Matthew Bondswell,Shrewsbury Town,50000,Wypożyczenie,GB3,2021,50000,0
Sam Sherring,Accrington Stanley,0,Wypożyczenie,GB3,2021,0,0
Sam Sherring,Cambridge United,0,Wypożyczenie,GB3,2021,0,0
Scott Robertson,Crewe Alexandra,0,Wypożyczenie,GB3,2021,150000,150000
Scott Robertson,FC Gillingham,0,Wypożyczenie,GB3,2020,150000,150000
Scott Robertson,Doncaster Rovers,0,Wypożyczenie,GB3,2020,150000,150000
Jack Young,Wycombe Wanderers,0,Wypożyczenie,GB3,2021,250000,250000
Jack Young,Tranmere Rovers,0,Wypożyczenie,GB4,2020,250000,250000
Callum Jones,FC Morecambe,0,Wypożyczenie,GB3,2021,100000,100000
Callum Johnson,Fleetwood Town,0,Wypożyczenie,GB3,2021,400000,400000
Archie Mair,Lincoln City,0,Wypożyczenie,GB3,2021,0,0
Kion Etete,Cheltenham Town,0,Wypożyczenie,GB3,2021,900000,900000
Kion Etete,Northampton Town,0,Wypożyczenie,GB4,2021,900000,900000
Callum Wright,Cheltenham Town,0,Wypożyczenie,GB3,2021,400000,400000
Callum Wright,Cheltenham Town,0,Wypożyczenie,GB4,2020,400000,400000
Ryan Alebiosu,Crewe Alexandra,0,Wypożyczenie,GB3,2021,350000,350000
Ryan Edmondson,Fleetwood Town,0,Wypożyczenie,GB3,2021,0,0
Ryan Edmondson,Port Vale FC,0,Wypożyczenie,GB4,2021,0,0
Ryan Edmondson,Northampton Town,0,Wypożyczenie,GB3,2020,0,0
Sam Hughes,Burton Albion,0,Wypożyczenie,GB3,2021,300000,300000
Sam Hughes,Burton Albion,0,Wypożyczenie,GB3,2020,300000,300000
Sam Hughes,Salford City,0,Wypożyczenie,GB4,2019,300000,300000
Tiago Cukur,Doncaster Rovers,0,Wypożyczenie,GB3,2021,250000,250000
James Trafford,Accrington Stanley,0,Wypożyczenie,GB3,2021,1000000,1000000
James Trafford,Bolton Wanderers,0,Wypożyczenie,GB3,2021,1000000,1000000
Ben Jackson,Doncaster Rovers,0,Wypożyczenie,GB3,2021,0,0
Ben Jackson,Bolton Wanderers,0,Wypożyczenie,GB4,2020,0,0
Jovan Malcolm,Accrington Stanley,0,Wypożyczenie,GB3,2021,0,0
Terry Ablade,AFC Wimbledon,0,Wypożyczenie,GB3,2021,200000,200000
Gavin Bazunu,FC Portsmouth,0,Wypożyczenie,GB3,2021,18000000,18000000
Gavin Bazunu,AFC Rochdale,0,Wypożyczenie,GB3,2020,18000000,18000000
Yeboah Amankwah,Accrington Stanley,0,Wypożyczenie,GB3,2021,350000,350000
Yeboah Amankwah,AFC Rochdale,0,Wypożyczenie,GB3,2020,350000,350000
Jamie Soule,Cheltenham Town,0,Wypożyczenie,GB3,2021,0,0
Jamie Soule,Lincoln City,0,Wypożyczenie,GB3,2020,0,0
Mason Burstow,Charlton Athletic,0,Wypożyczenie,GB3,2021,200000,200000
J'Neil Bennett,Crewe Alexandra,0,Wypożyczenie,GB3,2021,0,0
Nathan Holland,Oxford United,0,Wypożyczenie,GB3,2021,500000,500000
Nathan Holland,Oxford United,0,Wypożyczenie,GB3,2019,500000,500000
Ben Knight,Crewe Alexandra,0,Wypożyczenie,GB3,2021,300000,300000
Tomas Kalinauskas,AFC Wimbledon,0,Wypożyczenie,GB3,2021,0,0
Marlon Fossey,Bolton Wanderers,0,Wypożyczenie,GB3,2021,2000000,2000000
Marlon Fossey,Shrewsbury Town,0,Wypożyczenie,GB3,2020,2000000,2000000
Luke Matheson,Scunthorpe United,600000,Wypożyczenie,GB4,2021,600000,0
Luke Matheson,Ipswich Town,900000,Wypożyczenie,GB3,2020,600000,-300000
Luke Matheson,AFC Rochdale,0,Wypożyczenie,GB3,2019,600000,600000
Jamie Murphy,Mansfield Town,550000,Wypożyczenie,GB4,2021,450000,-100000
Jamie Murphy,Burton Albion,1000000,Wypożyczenie,GB3,2019,450000,-550000
Luke Thomas,Bristol Rovers,500000,Wypożyczenie,GB4,2021,500000,0
Luke Thomas,Ipswich Town,800000,Wypożyczenie,GB3,2020,500000,-300000
Luke Thomas,Coventry City,0,Wypożyczenie,GB3,2018,500000,500000
Tom Elliott,Bradford City,400000,Wypożyczenie,GB4,2021,150000,-250000
Jamie Walker,Bradford City,400000,Wypożyczenie,GB4,2021,400000,0
Jamie Walker,Peterborough United,750000,Wypożyczenie,GB3,2018,400000,-350000
Stephen Kelly,Salford City,400000,Wypożyczenie,GB4,2021,400000,0
Michael Bostwick,FC Stevenage,325000,Wypożyczenie,GB4,2021,325000,0
Josh Pask,Newport County,300000,Wypożyczenie,GB4,2021,100000,-200000
Nathan Bishop,Mansfield Town,300000,Wypożyczenie,GB4,2021,300000,0
Frank Fielding,Salford City,300000,Wypożyczenie,GB4,2021,250000,-50000
Padraig Amond,Exeter City,300000,Wypożyczenie,GB4,2021,0,-300000
Cameron Dawson,Exeter City,300000,Wypożyczenie,GB4,2021,300000,0
Stephen Walker,Tranmere Rovers,250000,Wypożyczenie,GB4,2021,200000,-50000
Stephen Walker,Crewe Alexandra,250000,Wypożyczenie,GB3,2020,200000,-50000
Stephen Walker,Milton Keynes Dons,250000,Wypożyczenie,GB3,2020,200000,-50000
Stephen Walker,Crewe Alexandra,250000,Wypożyczenie,GB4,2019,200000,-50000
Stephen Walker,Milton Keynes Dons,0,Wypożyczenie,GB4,2018,200000,200000
Ross Doohan,Tranmere Rovers,250000,Wypożyczenie,GB4,2021,250000,0
Anthony Driscoll-Glennon,AFC Barrow,250000,Wypożyczenie,GB4,2021,250000,0
Anthony Driscoll-Glennon,Grimsby Town,0,Wypożyczenie,GB4,2019,250000,250000
Paul Downing,AFC Rochdale,250000,Wypożyczenie,GB4,2021,250000,0
Paul Downing,Doncaster Rovers,250000,Wypożyczenie,GB3,2018,250000,0
Nathan Delfouneso,Bradford City,250000,Wypożyczenie,GB4,2021,250000,0
Tyler Magloire,Northampton Town,250000,Wypożyczenie,GB4,2021,250000,0
Tyler Magloire,AFC Rochdale,0,Wypożyczenie,GB3,2019,250000,250000
Myles Kenlock,Colchester United,250000,Wypożyczenie,GB4,2021,250000,0
Bryn Morris,Hartlepool United,250000,Wypożyczenie,GB4,2021,250000,0
Bryn Morris,Northampton Town,250000,Wypożyczenie,GB3,2020,250000,0
Bryn Morris,Wycombe Wanderers,250000,Wypożyczenie,GB3,2018,250000,0
Connor Ripley,Salford City,250000,Wypożyczenie,GB4,2021,250000,0
Connor Ripley,Accrington Stanley,250000,Wypożyczenie,GB3,2018,250000,0
Laurie Walker,Oldham Athletic,250000,Wypożyczenie,GB4,2021,0,-250000
Laurie Walker,Oldham Athletic,250000,Wypożyczenie,GB4,2020,0,-250000
Frank Nouble,Leyton Orient,250000,Wypożyczenie,GB4,2021,250000,0
Frank Nouble,Colchester United,250000,Wypożyczenie,GB4,2020,250000,0
Faysal Bettache,Oldham Athletic,200000,Wypożyczenie,GB4,2021,200000,0
George Broadbent,AFC Rochdale,200000,Wypożyczenie,GB4,2021,0,-200000
Aaron Amadi-Holloway,AFC Barrow,200000,Wypożyczenie,GB4,2021,0,-200000
Tyler Burey,Hartlepool United,200000,Wypożyczenie,GB4,2021,900000,700000
Elliot Anderson,Bristol Rovers,200000,Wypożyczenie,GB4,2021,3000000,2800000
Alex Hunt,Oldham Athletic,200000,Wypożyczenie,GB4,2021,100000,-100000
Richard Nartey,Mansfield Town,200000,Wypożyczenie,GB4,2021,200000,0
Richard Nartey,Burton Albion,0,Wypożyczenie,GB3,2019,200000,200000
Oliver Cooper,Newport County,150000,Wypożyczenie,GB4,2021,2000000,1850000
Reece Devine,FC Walsall,150000,Wypożyczenie,GB4,2021,150000,0
Brad Young,Carlisle United,150000,Wypożyczenie,GB4,2021,200000,50000
Dominic Revan,Northampton Town,150000,Wypożyczenie,GB4,2021,0,-150000
Nicholas Bilokapic,Hartlepool United,150000,Wypożyczenie,GB4,2021,200000,50000
Idris Kanu,Northampton Town,150000,Wypożyczenie,GB4,2021,0,-150000
Idris Kanu,Port Vale FC,75000,Wypożyczenie,GB4,2018,0,-75000
Jeriel Dorsett,AFC Rochdale,150000,Wypożyczenie,GB4,2021,250000,100000
Blondy Nna Noukeu,Crawley Town,150000,Wypożyczenie,GB4,2021,150000,0
Jake Hull,Hartlepool United,100000,Wypożyczenie,GB4,2021,100000,0
Isaac Hutchinson,Crawley Town,100000,Wypożyczenie,GB4,2021,100000,0
Isaac Hutchinson,Forest Green Rovers,0,Wypożyczenie,GB4,2020,100000,100000
George Miller,FC Walsall,100000,Wypożyczenie,GB4,2021,100000,0
George Miller,Scunthorpe United,100000,Wypożyczenie,GB4,2019,100000,0
George Miller,Bradford City,100000,Wypożyczenie,GB3,2018,100000,0
Festus Arthur,AFC Barrow,100000,Wypożyczenie,GB4,2021,0,-100000
Zach Jeacock,Salford City,100000,Wypożyczenie,GB4,2021,100000,0
Isaac Fletcher,Hartlepool United,100000,Wypożyczenie,GB4,2021,100000,0
Max Melbourne,FC Stevenage,100000,Wypożyczenie,GB4,2021,100000,0
Max Melbourne,FC Walsall,100000,Wypożyczenie,GB4,2020,100000,0
Max Melbourne,Lincoln City,100000,Wypożyczenie,GB3,2019,100000,0
Ryan Delaney,Scunthorpe United,100000,Wypożyczenie,GB4,2021,100000,0
Ryan Delaney,AFC Wimbledon,100000,Wypożyczenie,GB3,2019,100000,0
Tom Billson,Scunthorpe United,100000,Wypożyczenie,GB4,2021,100000,0
Jordan Flores,Northampton Town,100000,Wypożyczenie,GB4,2021,100000,0
Owura Edwards,Exeter City,100000,Wypożyczenie,GB4,2021,350000,250000
Owura Edwards,Colchester United,100000,Wypożyczenie,GB4,2021,350000,250000
Owura Edwards,Grimsby Town,0,Wypożyczenie,GB4,2020,350000,350000
Alex Gilbert,Swindon Town,100000,Wypożyczenie,GB4,2021,100000,0
George Ray,Leyton Orient,100000,Wypożyczenie,GB4,2021,100000,0
Hayden Hackney,Scunthorpe United,100000,Wypożyczenie,GB4,2021,2000000,1900000
Jake Turner,Colchester United,100000,Wypożyczenie,GB4,2021,100000,0
Jake Turner,FC Morecambe,100000,Wypożyczenie,GB4,2020,100000,0
Amrit Bansal-McNulty,Crawley Town,100000,Wypożyczenie,GB4,2021,100000,0
Lee O'Connor,Tranmere Rovers,100000,Wypożyczenie,GB4,2021,100000,0
Lee O'Connor,Tranmere Rovers,100000,Wypożyczenie,GB4,2020,100000,0
Jack Aitchison,Forest Green Rovers,100000,Wypożyczenie,GB4,2021,200000,100000
Jack Aitchison,FC Stevenage,0,Wypożyczenie,GB4,2020,200000,200000
Jack Aitchison,Forest Green Rovers,0,Wypożyczenie,GB4,2019,200000,200000
Brahima Diarra,Harrogate Town,100000,Wypożyczenie,GB4,2021,300000,200000
Isaac Olaofe,Sutton United,75000,Wypożyczenie,GB4,2021,150000,75000
Alex Bass,Bradford City,50000,Wypożyczenie,GB4,2021,200000,150000
Will Forrester,Mansfield Town,50000,Wypożyczenie,GB4,2021,300000,250000
Jake O'Brien,Swindon Town,25000,Wypożyczenie,GB4,2021,500000,475000
Timmy Abraham,Newport County,0,Wypożyczenie,GB4,2021,200000,200000
Timmy Abraham,Plymouth Argyle,0,Wypożyczenie,GB3,2020,200000,200000
Timmy Abraham,Bristol Rovers,0,Wypożyczenie,GB3,2019,200000,200000
Josh Davison,Swindon Town,0,Wypożyczenie,GB4,2021,0,0
Josh Davison,Forest Green Rovers,0,Wypożyczenie,GB4,2020,0,0
Theo Archibald,Leyton Orient,0,Wypożyczenie,GB4,2021,0,0
Theo Archibald,Forest Green Rovers,0,Wypożyczenie,GB4,2018,0,0
Sam Hornby,Colchester United,0,Wypożyczenie,GB4,2021,0,0
Jake Cain,Newport County,0,Wypożyczenie,GB4,2021,0,0
Edward Jones,Hartlepool United,0,Wypożyczenie,GB4,2021,0,0
Will Harris,AFC Barrow,0,Wypożyczenie,GB4,2021,0,0
Zain Westbrooke,FC Stevenage,0,Wypożyczenie,GB4,2021,200000,200000
Tyrese Omotoye,Leyton Orient,0,Wypożyczenie,GB4,2021,0,0
Tyrese Omotoye,Carlisle United,0,Wypożyczenie,GB4,2021,0,0
Tyrese Omotoye,Swindon Town,0,Wypożyczenie,GB3,2020,0,0
Jacob Wakeling,AFC Barrow,0,Wypożyczenie,GB4,2021,0,0
Corie Andrews,Colchester United,0,Wypożyczenie,GB4,2021,0,0
Kieran O'Hara,Scunthorpe United,0,Wypożyczenie,GB4,2021,0,0
Kieran O'Hara,Burton Albion,0,Wypożyczenie,GB3,2019,0,0
Kieran O'Hara,Macclesfield Town FC,0,Wypożyczenie,GB4,2018,0,0
Sam Burns,Scunthorpe United,0,Wypożyczenie,GB4,2021,0,0
Ryan Stirk,Mansfield Town,0,Wypożyczenie,GB4,2021,0,0
Offrande Zanzala,Exeter City,0,Wypożyczenie,GB4,2021,0,0
Tyrese Shade,FC Walsall,0,Wypożyczenie,GB4,2021,0,0
Will Ferry,Crawley Town,0,Wypożyczenie,GB4,2021,0,0
Alex Mitchell,Leyton Orient,0,Wypożyczenie,GB4,2021,325000,325000
George Shelvey,Mansfield Town,0,Wypożyczenie,GB4,2021,0,0
Harry Wood,Scunthorpe United,0,Wypożyczenie,GB4,2021,0,0
Cameron Coxe,Colchester United,0,Wypożyczenie,GB4,2021,0,0
Sion Spence,Bristol Rovers,0,Wypożyczenie,GB4,2021,0,0
Will Goodwin,Hartlepool United,0,Wypożyczenie,GB4,2021,0,0
Rekeil Pyke,Scunthorpe United,0,Wypożyczenie,GB4,2021,100000,100000
Rekeil Pyke,AFC Rochdale,0,Wypożyczenie,GB3,2019,100000,100000
Rekeil Pyke,AFC Rochdale,0,Wypożyczenie,GB3,2018,100000,100000
Lewis Cass,Port Vale FC,0,Wypożyczenie,GB4,2021,150000,150000
Corey O'Keeffe,AFC Rochdale,0,Wypożyczenie,GB4,2021,200000,200000
Corey O'Keeffe,Macclesfield Town FC,0,Wypożyczenie,GB4,2019,200000,200000
Tyrese Sinclair,Scunthorpe United,0,Wypożyczenie,GB4,2021,0,0
Mitchell Roberts,Carlisle United,0,Wypożyczenie,GB4,2021,0,0
Mitchell Roberts,Harrogate Town,0,Wypożyczenie,GB4,2020,0,0
Jonathan Dinzeyi,Carlisle United,0,Wypożyczenie,GB4,2021,0,0
Connor Taylor,Bristol Rovers,0,Wypożyczenie,GB4,2021,1000000,1000000
Bailey Clements,FC Stevenage,0,Wypożyczenie,GB4,2021,0,0
Owen Windsor,Carlisle United,0,Wypożyczenie,GB4,2021,0,0
Owen Windsor,Grimsby Town,0,Wypożyczenie,GB4,2020,0,0
Owen Windsor,Newport County,0,Wypożyczenie,GB4,2020,0,0
Tyreece Simpson,Swindon Town,0,Wypożyczenie,GB4,2021,300000,300000
Jamie Bowden,Oldham Athletic,0,Wypożyczenie,GB4,2021,0,0
Josh Hawkes,Tranmere Rovers,0,Wypożyczenie,GB4,2021,0,0
Joel Cooper,Port Vale FC,0,Wypożyczenie,GB4,2021,100000,100000
Jake Scrimshaw,Scunthorpe United,0,Wypożyczenie,GB4,2021,0,0
Jake Scrimshaw,FC Walsall,0,Wypożyczenie,GB4,2020,0,0
Jake Scrimshaw,Newport County,0,Wypożyczenie,GB4,2020,0,0
Armando Dobra,Colchester United,0,Wypożyczenie,GB4,2021,0,0
James Connolly,Bristol Rovers,0,Wypożyczenie,GB4,2021,300000,300000
Dan Moss,Leyton Orient,0,Wypożyczenie,GB4,2021,0,0
Rabbi Matondo,Stoke City,8000000,Wypożyczenie,GB2,2020,3000000,-5000000
Tomás Esteves,FC Reading,8000000,Wypożyczenie,GB2,2020,1000000,-7000000
Oliver Skipp,Norwich City,7000000,Wypożyczenie,GB2,2020,15000000,8000000
Filip Benkovic,Cardiff City,7000000,Wypożyczenie,GB2,2020,1000000,-6000000
Filip Benkovic,Bristol City,9000000,Wypożyczenie,GB2,2019,1000000,-8000000
Alfie Mawson,Bristol City,7000000,Wypożyczenie,GB2,2020,0,-7000000
Filip Krovinovic,Nottingham Forest,6000000,Wypożyczenie,GB2,2020,5000000,-1000000
Filip Krovinovic,West Bromwich Albion,5000000,Wypożyczenie,GB2,2019,5000000,0
Yan Valery,Birmingham City,6000000,Wypożyczenie,GB2,2020,2000000,-4000000
Anthony Gordon,Preston North End,5000000,Wypożyczenie,GB2,2020,40000000,35000000
Jordan Morris,Swansea City,5000000,Wypożyczenie,GB2,2020,5000000,0
Carel Eiting,Huddersfield Town,4000000,Wypożyczenie,GB2,2020,2000000,-2000000
Harvey Elliott,Blackburn Rovers,4000000,Wypożyczenie,GB2,2020,35000000,31000000
Xavi Quintillà,Norwich City,4000000,Wypożyczenie,GB2,2020,1000000,-3000000
Angus Gunn,Stoke City,4000000,Wypożyczenie,GB2,2020,3000000,-1000000
Yannick Bolasie,FC Middlesbrough,3000000,Wypożyczenie,GB2,2020,275000,-2725000
Yannick Bolasie,Aston Villa,18000000,Wypożyczenie,GB2,2018,275000,-17725000
Kenneth Zohore,FC Millwall,3000000,Wypożyczenie,GB2,2020,700000,-2300000
Saman Ghoddos,FC Brentford,3000000,Wypożyczenie,GB2,2020,2000000,-1000000
Charlie Austin,Queens Park Rangers,3000000,Wypożyczenie,GB2,2020,800000,-2200000
Paul Arriola,Swansea City,3000000,Wypożyczenie,GB2,2020,4000000,1000000
Daryl Dike,FC Barnsley,3000000,Wypożyczenie,GB2,2020,7000000,4000000
Shane Long,AFC Bournemouth,2000000,Wypożyczenie,GB2,2020,300000,-1700000
Tom Trybull,Blackburn Rovers,2000000,Wypożyczenie,GB2,2020,800000,-1200000
Patrick Roberts,FC Middlesbrough,2000000,Wypożyczenie,GB2,2020,2000000,0
Patrick Roberts,Derby County,2000000,Wypożyczenie,GB2,2020,2000000,0
Patrick Roberts,FC Middlesbrough,3000000,Wypożyczenie,GB2,2019,2000000,-1000000
Marc Guéhi,Swansea City,2000000,Wypożyczenie,GB2,2020,35000000,33000000
Marc Guéhi,Swansea City,1000000,Wypożyczenie,GB2,2019,35000000,34000000
Jack Marriott,Sheffield Wednesday,2000000,Wypożyczenie,GB2,2020,900000,-1100000
Rodrigo Riquelme,AFC Bournemouth,2000000,Wypożyczenie,GB2,2020,10000000,8000000
Barry Douglas,Blackburn Rovers,2000000,Wypożyczenie,GB2,2020,400000,-1600000
Jarrad Branthwaite,Blackburn Rovers,2000000,Wypożyczenie,GB2,2020,7000000,5000000
Stefan Johansen,Queens Park Rangers,2000000,Wypożyczenie,GB2,2020,1000000,-1000000
Stefan Johansen,West Bromwich Albion,4000000,Wypożyczenie,GB2,2018,1000000,-3000000
Scott Malone,FC Millwall,2000000,Wypożyczenie,GB2,2020,1000000,-1000000
Izzy Brown,Sheffield Wednesday,2000000,Wypożyczenie,GB2,2020,600000,-1400000
Izzy Brown,Luton Town,5000000,Wypożyczenie,GB2,2019,600000,-4400000
Izzy Brown,Leeds United,5000000,Wypożyczenie,GB2,2018,600000,-4400000
Cameron Carter-Vickers,AFC Bournemouth,2000000,Wypożyczenie,GB2,2020,11000000,9000000
Cameron Carter-Vickers,Luton Town,2000000,Wypożyczenie,GB2,2019,11000000,9000000
Cameron Carter-Vickers,Stoke City,1000000,Wypożyczenie,GB2,2019,11000000,10000000
Cameron Carter-Vickers,Swansea City,1000000,Wypożyczenie,GB2,2018,11000000,10000000
Sepp van den Berg,Preston North End,1000000,Wypożyczenie,GB2,2020,5000000,4000000
Glenn Murray,FC Watford,1000000,Wypożyczenie,GB2,2020,0,-1000000
Jordy de Wijs,Queens Park Rangers,1000000,Wypożyczenie,GB2,2020,1000000,0
Alfa Semedo,FC Reading,1000000,Wypożyczenie,GB2,2020,1000000,0
Alfa Semedo,Nottingham Forest,2000000,Wypożyczenie,GB2,2019,1000000,-1000000
Marcus Bettinelli,FC Middlesbrough,1000000,Wypożyczenie,GB2,2020,2000000,1000000
Liam Lindsay,Preston North End,1000000,Wypożyczenie,GB2,2020,1000000,0
Winston Reid,FC Brentford,1000000,Wypożyczenie,GB2,2020,0,-1000000
Beni Baningime,Derby County,1000000,Wypożyczenie,GB2,2020,850000,-150000
Beni Baningime,Wigan Athletic,2000000,Wypożyczenie,GB2,2018,850000,-1150000
Matty James,Coventry City,1000000,Wypożyczenie,GB2,2020,900000,-100000
Matty James,FC Barnsley,1000000,Wypożyczenie,GB2,2020,900000,-100000
Kasey Palmer,Swansea City,1000000,Wypożyczenie,GB2,2020,1000000,0
Kasey Palmer,Blackburn Rovers,1000000,Wypożyczenie,GB2,2018,1000000,0
Kasey Palmer,Bristol City,1000000,Wypożyczenie,GB2,2018,1000000,0
Neeskens Kebano,FC Middlesbrough,1000000,Wypożyczenie,GB2,2020,3000000,2000000
Florian Jozefzoon,Rotherham United,1000000,Wypożyczenie,GB2,2020,500000,-500000
Cafú,Nottingham Forest,1000000,Wypożyczenie,GB2,2020,600000,-400000
Viktor Gyökeres,Coventry City,1000000,Wypożyczenie,GB2,2020,8000000,7000000
Viktor Gyökeres,Swansea City,1000000,Wypożyczenie,GB2,2020,8000000,7000000
Sam Field,Queens Park Rangers,1000000,Wypożyczenie,GB2,2020,2000000,1000000
Sam Field,Charlton Athletic,1000000,Wypożyczenie,GB2,2019,2000000,1000000
Riley McGree,Birmingham City,900000,Wypożyczenie,GB2,2020,3000000,2100000
Lee Gregory,Derby County,800000,Wypożyczenie,GB2,2020,250000,-550000
George Edmundson,Derby County,500000,Wypożyczenie,GB2,2020,500000,0
Rhys Norrington-Davies,Stoke City,500000,Wypożyczenie,GB2,2020,3000000,2500000
Rhys Norrington-Davies,Luton Town,0,Wypożyczenie,GB2,2020,3000000,3000000
Rhys Norrington-Davies,AFC Rochdale,0,Wypożyczenie,GB3,2019,3000000,3000000
Joel Pereira,Huddersfield Town,475000,Wypożyczenie,GB2,2020,300000,-175000
Jamal Blackman,Rotherham United,400000,Wypożyczenie,GB2,2020,500000,100000
Jamal Blackman,Bristol Rovers,500000,Wypożyczenie,GB3,2019,500000,0
Jamal Blackman,Leeds United,250000,Wypożyczenie,GB2,2018,500000,250000
Ched Evans,Preston North End,300000,Wypożyczenie,GB2,2020,250000,-50000
Ched Evans,Fleetwood Town,350000,Wypożyczenie,GB3,2018,250000,-100000
Nnamdi Ofoborh,Wycombe Wanderers,250000,Wypożyczenie,GB2,2020,400000,150000
Nnamdi Ofoborh,Wycombe Wanderers,150000,Wypożyczenie,GB3,2019,400000,250000
Dennis Adeniran,Wycombe Wanderers,0,Wypożyczenie,GB2,2020,700000,700000
Kiernan Dewsbury-Hall,Luton Town,0,Wypożyczenie,GB2,2020,25000000,25000000
Kiernan Dewsbury-Hall,FC Blackpool,0,Wypożyczenie,GB3,2019,25000000,25000000
Josh Knight,Wycombe Wanderers,0,Wypożyczenie,GB2,2020,600000,600000
Josh Knight,Peterborough United,0,Wypożyczenie,GB3,2019,600000,600000
Josh Knight,Peterborough United,0,Wypożyczenie,GB3,2018,600000,600000
Sam Nombe,Luton Town,0,Wypożyczenie,GB2,2020,250000,250000
Ben Sheaf,Coventry City,0,Wypożyczenie,GB2,2020,3000000,3000000
Ben Sheaf,Doncaster Rovers,0,Wypożyczenie,GB3,2019,3000000,3000000
Ben Woodburn,FC Blackpool,4000000,Wypożyczenie,GB3,2020,1000000,-3000000
Ben Woodburn,Oxford United,5000000,Wypożyczenie,GB3,2019,1000000,-4000000
Ben Woodburn,Sheffield United,5000000,Wypożyczenie,GB2,2018,1000000,-4000000
Josef Bursik,Lincoln City,2000000,Wypożyczenie,GB3,2020,2000000,0
Josef Bursik,Peterborough United,2000000,Wypożyczenie,GB3,2020,2000000,0
Josef Bursik,Doncaster Rovers,0,Wypożyczenie,GB3,2020,2000000,2000000
Josef Bursik,Accrington Stanley,0,Wypożyczenie,GB3,2019,2000000,2000000
Josh Sims,Doncaster Rovers,1000000,Wypożyczenie,GB3,2020,400000,-600000
Josh Sims,FC Reading,750000,Wypożyczenie,GB2,2018,400000,-350000
Callum Connolly,Fleetwood Town,1000000,Wypożyczenie,GB3,2020,1000000,0
Callum Connolly,Lincoln City,2000000,Wypożyczenie,GB3,2019,1000000,-1000000
Callum Connolly,Fleetwood Town,2000000,Wypożyczenie,GB3,2019,1000000,-1000000
Callum Connolly,Bolton Wanderers,2000000,Wypożyczenie,GB2,2018,1000000,-1000000
Callum Connolly,Wigan Athletic,1000000,Wypożyczenie,GB2,2018,1000000,0
George Byers,FC Portsmouth,1000000,Wypożyczenie,GB3,2020,450000,-550000
Dan Crowley,Hull City,1000000,Wypożyczenie,GB3,2020,600000,-400000
Keanan Bennetts,Ipswich Town,1000000,Wypożyczenie,GB3,2020,600000,-400000
Jayden Stockley,Charlton Athletic,900000,Wypożyczenie,GB3,2020,900000,0
Matthew Pennington,Shrewsbury Town,800000,Wypożyczenie,GB3,2020,600000,-200000
Matthew Pennington,Hull City,1000000,Wypożyczenie,GB2,2019,600000,-400000
Matthew Pennington,Ipswich Town,500000,Wypożyczenie,GB2,2018,600000,100000
Jan Zamburek,Shrewsbury Town,800000,Wypożyczenie,GB3,2020,500000,-300000
Barrie McKay,Fleetwood Town,800000,Wypożyczenie,GB3,2020,850000,50000
Barrie McKay,Fleetwood Town,1000000,Wypożyczenie,GB3,2019,850000,-150000
Dylan Levitt,Charlton Athletic,675000,Wypożyczenie,GB3,2020,800000,125000
Rasmus Nicolaisen,FC Portsmouth,600000,Wypożyczenie,GB3,2020,5000000,4400000
Jordan Jones,AFC Sunderland,600000,Wypożyczenie,GB3,2020,500000,-100000
Mark Travers,Swindon Town,500000,Wypożyczenie,GB3,2020,2000000,1500000
Brandon Barker,Oxford United,500000,Wypożyczenie,GB3,2020,350000,-150000
Brandon Barker,Preston North End,400000,Wypożyczenie,GB2,2018,350000,-50000
Josh Earl,Burton Albion,450000,Wypożyczenie,GB3,2020,800000,350000
Josh Earl,Bolton Wanderers,500000,Wypożyczenie,GB3,2019,800000,300000
Josh Earl,Ipswich Town,500000,Wypożyczenie,GB3,2019,800000,300000
Erhun Öztümer,Bristol Rovers,400000,Wypożyczenie,GB3,2020,300000,-100000
Andrew Shinnie,Charlton Athletic,400000,Wypożyczenie,GB3,2020,375000,-25000
Funso Ojo,Wigan Athletic,400000,Wypożyczenie,GB3,2020,450000,50000
Janoi Donacien,Fleetwood Town,400000,Wypożyczenie,GB3,2020,300000,-100000
Janoi Donacien,Ipswich Town,250000,Wypożyczenie,GB2,2018,300000,50000
Janoi Donacien,Accrington Stanley,750000,Wypożyczenie,GB3,2018,300000,-450000
Matthew Millar,Shrewsbury Town,400000,Wypożyczenie,GB3,2020,400000,0
Billy Jones,Crewe Alexandra,400000,Wypożyczenie,GB3,2020,0,-400000
Sean Clare,Burton Albion,350000,Wypożyczenie,GB3,2020,400000,50000
Antony Evans,Crewe Alexandra,350000,Wypożyczenie,GB3,2020,400000,50000
Antony Evans,FC Blackpool,0,Wypożyczenie,GB3,2018,400000,400000
Olly Lee,FC Gillingham,350000,Wypożyczenie,GB3,2020,0,-350000
Olly Lee,FC Gillingham,450000,Wypożyczenie,GB3,2019,0,-450000
Nathan Wood,Crewe Alexandra,300000,Wypożyczenie,GB3,2020,1000000,700000
Dejan Iliev,Shrewsbury Town,300000,Wypożyczenie,GB3,2020,325000,25000
Scott Wootton,Wigan Athletic,300000,Wypożyczenie,GB3,2020,300000,0
Kyle Vassell,Fleetwood Town,300000,Wypożyczenie,GB3,2020,350000,50000
Marcus McGuane,Oxford United,300000,Wypożyczenie,GB3,2020,300000,0
Luka Racic,Northampton Town,300000,Wypożyczenie,GB3,2020,250000,-50000
Mickel Miller,Northampton Town,300000,Wypożyczenie,GB3,2020,300000,0
Jonathan Mitchell,Northampton Town,250000,Wypożyczenie,GB3,2020,250000,0
Jonathan Mitchell,Macclesfield Town FC,250000,Wypożyczenie,GB4,2019,250000,0
Jonathan Mitchell,Shrewsbury Town,150000,Wypożyczenie,GB3,2018,250000,100000
Jonathan Mitchell,Oxford United,150000,Wypożyczenie,GB3,2018,250000,100000
Louis Thompson,Milton Keynes Dons,250000,Wypożyczenie,GB3,2020,200000,-50000
Louis Thompson,Shrewsbury Town,250000,Wypożyczenie,GB3,2019,200000,-50000
Louis Thompson,Milton Keynes Dons,250000,Wypożyczenie,GB3,2019,200000,-50000
Joe Nuttall,Northampton Town,250000,Wypożyczenie,GB3,2020,0,-250000
Joe Day,Bristol Rovers,250000,Wypożyczenie,GB3,2020,250000,0
Joe Day,AFC Wimbledon,250000,Wypożyczenie,GB3,2019,250000,0
Indiana Vassilev,Burton Albion,250000,Wypożyczenie,GB3,2020,1000000,750000
Indiana Vassilev,Cheltenham Town,250000,Wypożyczenie,GB4,2020,1000000,750000
Jake Vokins,AFC Sunderland,250000,Wypożyczenie,GB3,2020,0,-250000
Paul Smyth,Charlton Athletic,250000,Wypożyczenie,GB3,2020,250000,0
Paul Smyth,Accrington Stanley,250000,Wypożyczenie,GB3,2020,250000,0
Paul Smyth,Wycombe Wanderers,250000,Wypożyczenie,GB3,2019,250000,0
Paul Smyth,Accrington Stanley,250000,Wypożyczenie,GB3,2018,250000,0
Robbie Gotts,Lincoln City,250000,Wypożyczenie,GB3,2020,250000,0
Robbie Gotts,Salford City,250000,Wypożyczenie,GB4,2020,250000,0
George Johnston,Wigan Athletic,250000,Wypożyczenie,GB3,2020,600000,350000
Jaakko Oksanen,AFC Wimbledon,250000,Wypożyczenie,GB3,2020,300000,50000
Charlie Mulgrew,Fleetwood Town,250000,Wypożyczenie,GB3,2020,300000,50000
Charlie Mulgrew,Wigan Athletic,1000000,Wypożyczenie,GB2,2019,300000,-700000
Elliot Simoes,Doncaster Rovers,250000,Wypożyczenie,GB3,2020,300000,50000
Joe Wollacott,Swindon Town,200000,Wypożyczenie,GB3,2020,300000,100000
Joe Wollacott,Forest Green Rovers,100000,Wypożyczenie,GB4,2019,300000,200000
Jordan Stevens,Swindon Town,200000,Wypożyczenie,GB3,2020,0,-200000
Jordan Stevens,Bradford City,200000,Wypożyczenie,GB4,2020,0,-200000
Tom James,Wigan Athletic,200000,Wypożyczenie,GB3,2020,200000,0
Tom James,Salford City,200000,Wypożyczenie,GB4,2020,200000,0
Carlton Morris,Milton Keynes Dons,150000,Wypożyczenie,GB3,2020,2000000,1850000
Carlton Morris,Rotherham United,150000,Wypożyczenie,GB3,2019,2000000,1850000
Carlton Morris,Milton Keynes Dons,150000,Wypożyczenie,GB3,2019,2000000,1850000
Sam Walker,AFC Wimbledon,150000,Wypożyczenie,GB3,2020,400000,250000
Sam Walker,FC Blackpool,150000,Wypożyczenie,GB3,2020,400000,250000
Jamie Proctor,Wigan Athletic,150000,Wypożyczenie,GB3,2020,250000,100000
Jamie Proctor,Newport County,150000,Wypożyczenie,GB4,2020,250000,100000
Jamie Proctor,Scunthorpe United,175000,Wypożyczenie,GB4,2019,250000,75000
Josh Eccles,FC Gillingham,100000,Wypożyczenie,GB3,2020,300000,200000
Gabriel Osho,AFC Rochdale,100000,Wypożyczenie,GB3,2020,400000,300000
Gabriel Osho,Bristol Rovers,0,Wypożyczenie,GB3,2018,400000,400000
Sam Woods,Plymouth Argyle,75000,Wypożyczenie,GB3,2020,0,-75000
Dillon Barnes,Burton Albion,50000,Wypożyczenie,GB3,2020,150000,100000
Callum Slattery,FC Gillingham,50000,Wypożyczenie,GB3,2020,450000,400000
George Dobson,AFC Wimbledon,0,Wypożyczenie,GB3,2020,400000,400000
Matt Palmer,Wigan Athletic,0,Wypożyczenie,GB3,2020,0,0
Matt Palmer,Bradford City,250000,Wypożyczenie,GB4,2019,0,-250000
Liam Kelly,Oxford United,0,Wypożyczenie,GB3,2020,600000,600000
Liam Kelly,Oxford United,0,Wypożyczenie,GB3,2020,475000,475000
Liam Kelly,Oxford United,600000,Wypożyczenie,GB3,2019,600000,0
Liam Kelly,Oxford United,600000,Wypożyczenie,GB3,2019,475000,-125000
Ryan Hardie,Plymouth Argyle,0,Wypożyczenie,GB3,2020,600000,600000
Ryan Hardie,Plymouth Argyle,0,Wypożyczenie,GB4,2019,600000,600000
Declan Drysdale,FC Gillingham,0,Wypożyczenie,GB3,2020,0,0
Declan Drysdale,Cambridge United,0,Wypożyczenie,GB4,2020,0,0
Morgan Boyes,Fleetwood Town,0,Wypożyczenie,GB3,2020,250000,250000
Robbie Cundy,FC Gillingham,0,Wypożyczenie,GB3,2020,200000,200000
Robbie Cundy,Cambridge United,0,Wypożyczenie,GB4,2020,200000,200000
Robbie Cundy,Exeter City,0,Wypożyczenie,GB4,2019,200000,200000
Regan Slater,Hull City,0,Wypożyczenie,GB3,2020,2000000,2000000
Regan Slater,Scunthorpe United,0,Wypożyczenie,GB4,2019,2000000,2000000
Regan Slater,Carlisle United,0,Wypożyczenie,GB4,2018,2000000,2000000
Ryan Cassidy,Accrington Stanley,0,Wypożyczenie,GB3,2020,0,0
Lewis Ward,FC Portsmouth,0,Wypożyczenie,GB3,2020,0,0
Lewis Ward,Forest Green Rovers,0,Wypożyczenie,GB4,2018,0,0
Lewis Ward,Northampton Town,0,Wypożyczenie,GB4,2018,0,0
Jordan Lawrence-Gabriel,FC Blackpool,0,Wypożyczenie,GB3,2020,1000000,1000000
Jordan Lawrence-Gabriel,Scunthorpe United,0,Wypożyczenie,GB4,2019,1000000,1000000
Trae Coyle,FC Gillingham,0,Wypożyczenie,GB3,2020,400000,400000
Cameron Pring,FC Portsmouth,0,Wypożyczenie,GB3,2020,400000,400000
Cameron Pring,FC Walsall,0,Wypożyczenie,GB4,2019,400000,400000
Cameron Pring,Cheltenham Town,0,Wypożyczenie,GB4,2018,400000,400000
Cameron Pring,Newport County,0,Wypożyczenie,GB4,2018,400000,400000
Lasse Sörensen,Milton Keynes Dons,0,Wypożyczenie,GB3,2020,450000,450000
Tariq Uwakwe,Accrington Stanley,0,Wypożyczenie,GB3,2020,0,0
Shilow Tracey,Shrewsbury Town,0,Wypożyczenie,GB3,2020,250000,250000
Shilow Tracey,Cambridge United,0,Wypożyczenie,GB4,2020,250000,250000
Shilow Tracey,Macclesfield Town FC,0,Wypożyczenie,GB4,2019,250000,250000
Harry Pickering,Crewe Alexandra,0,Wypożyczenie,GB3,2020,3000000,3000000
Warren O'Hora,Milton Keynes Dons,0,Wypożyczenie,GB3,2020,600000,600000
Tyreke Johnson,FC Gillingham,0,Wypożyczenie,GB3,2020,0,0
Darnell Johnson,Wigan Athletic,0,Wypożyczenie,GB3,2020,150000,150000
Darnell Johnson,AFC Wimbledon,0,Wypożyczenie,GB3,2020,150000,150000
Tom Allan,Accrington Stanley,0,Wypożyczenie,GB3,2020,0,0
Jayden Mitchell-Lawson,Bristol Rovers,0,Wypożyczenie,GB3,2020,150000,150000
Jayden Mitchell-Lawson,Bristol Rovers,0,Wypożyczenie,GB3,2019,150000,150000
Niall Ennis,Burton Albion,0,Wypożyczenie,GB3,2020,350000,350000
Niall Ennis,Doncaster Rovers,0,Wypożyczenie,GB3,2019,350000,350000
Jon Russell,Accrington Stanley,0,Wypożyczenie,GB3,2020,900000,900000
James Morton,FC Gillingham,0,Wypożyczenie,GB3,2020,0,0
James Morton,Grimsby Town,0,Wypożyczenie,GB4,2020,0,0
James Morton,Forest Green Rovers,0,Wypożyczenie,GB4,2019,0,0
Liam Millar,Charlton Athletic,0,Wypożyczenie,GB3,2020,1000000,1000000
Brennan Johnson,Lincoln City,0,Wypożyczenie,GB3,2020,30000000,30000000
Mo Sangare,Accrington Stanley,0,Wypożyczenie,GB3,2020,200000,200000
Thomas O'Connor,FC Gillingham,0,Wypożyczenie,GB3,2020,0,0
Thomas O'Connor,FC Gillingham,0,Wypożyczenie,GB3,2019,0,0
Jonny Smith,Swindon Town,0,Wypożyczenie,GB3,2020,300000,300000
Jonny Smith,Oldham Athletic,0,Wypożyczenie,GB4,2019,300000,300000
Jonny Smith,Tranmere Rovers,0,Wypożyczenie,GB4,2018,300000,300000
Luke McCormick,Bristol Rovers,0,Wypożyczenie,GB3,2020,0,0
Luke McCormick,Shrewsbury Town,0,Wypożyczenie,GB3,2019,0,0
Elliot Embleton,FC Blackpool,0,Wypożyczenie,GB3,2020,1000000,1000000
Elliot Embleton,Grimsby Town,0,Wypożyczenie,GB4,2018,1000000,1000000
Joe Hilton,Fleetwood Town,0,Wypożyczenie,GB3,2020,150000,150000
Zechariah Medley,FC Gillingham,0,Wypożyczenie,GB3,2020,500000,500000
Jack Roles,Burton Albion,0,Wypożyczenie,GB3,2020,0,0
Jack Roles,FC Stevenage,0,Wypożyczenie,GB4,2020,0,0
Jack Roles,Cambridge United,0,Wypożyczenie,GB4,2019,0,0
Jerome Opoku,Plymouth Argyle,0,Wypożyczenie,GB3,2020,700000,700000
Jerome Opoku,Accrington Stanley,0,Wypożyczenie,GB3,2019,700000,700000
Timothy Eyoma,Lincoln City,0,Wypożyczenie,GB3,2020,500000,500000
Timothy Eyoma,Lincoln City,0,Wypożyczenie,GB3,2019,500000,500000
Jack Vale,AFC Rochdale,0,Wypożyczenie,GB3,2020,500000,500000
Teddy Sharman-Lowe,Burton Albion,0,Wypożyczenie,GB3,2020,0,0
Kazaiah Sterling,Southend United,1000000,Wypożyczenie,GB4,2020,300000,-700000
Kazaiah Sterling,Doncaster Rovers,2000000,Wypożyczenie,GB3,2019,300000,-1700000
Kazaiah Sterling,Leyton Orient,2000000,Wypożyczenie,GB4,2019,300000,-1700000
Kazaiah Sterling,AFC Sunderland,0,Wypożyczenie,GB3,2018,300000,300000
Liam Feeney,Tranmere Rovers,600000,Wypożyczenie,GB4,2020,0,-600000
Stephen Quinn,Mansfield Town,600000,Wypożyczenie,GB4,2020,600000,0
Ali Crawford,Tranmere Rovers,550000,Wypożyczenie,GB4,2020,375000,-175000
Hiram Boateng,Cambridge United,400000,Wypożyczenie,GB4,2020,400000,0
Declan John,Bolton Wanderers,400000,Wypożyczenie,GB4,2020,450000,50000
Declan John,AFC Sunderland,800000,Wypożyczenie,GB3,2019,450000,-350000
David Nugent,Tranmere Rovers,300000,Wypożyczenie,GB4,2020,0,-300000
Marcel Hilßner,Oldham Athletic,300000,Wypożyczenie,GB4,2020,200000,-100000
David Stockdale,FC Stevenage,300000,Wypożyczenie,GB4,2020,150000,-150000
David Stockdale,Wycombe Wanderers,500000,Wypożyczenie,GB3,2019,150000,-350000
David Stockdale,Southend United,2000000,Wypożyczenie,GB3,2018,150000,-1850000
David Stockdale,Wycombe Wanderers,1000000,Wypożyczenie,GB3,2018,150000,-850000
David Stockdale,Coventry City,1000000,Wypożyczenie,GB3,2018,150000,-850000
Nicky Maynard,Newport County,300000,Wypożyczenie,GB4,2020,0,-300000
Derick Osei,FC Walsall,250000,Wypożyczenie,GB4,2020,250000,0
Brad Lyons,FC Morecambe,250000,Wypożyczenie,GB4,2020,200000,-50000
Brad Lyons,Blackburn Rovers,0,Wypożyczenie,GB2,2018,200000,200000
Jake Hesketh,Crawley Town,200000,Wypożyczenie,GB4,2020,0,-200000
Jake Hesketh,Lincoln City,200000,Wypożyczenie,GB3,2019,0,-200000
Jake Hesketh,Burton Albion,0,Wypożyczenie,GB3,2018,0,0
Jake Hesketh,Milton Keynes Dons,0,Wypożyczenie,GB4,2018,0,0
Luke Gambin,Newport County,200000,Wypożyczenie,GB4,2020,250000,50000
Luke Gambin,Crawley Town,200000,Wypożyczenie,GB4,2018,250000,50000
Mace Goodridge,AFC Barrow,200000,Wypożyczenie,GB4,2020,0,-200000
Nick Freeman,Leyton Orient,200000,Wypożyczenie,GB4,2020,150000,-50000
Ben Coker,FC Stevenage,150000,Wypożyczenie,GB4,2020,0,-150000
Ben Coker,Cambridge United,150000,Wypożyczenie,GB4,2019,0,-150000
Tom Davies,AFC Barrow,150000,Wypożyczenie,GB4,2020,150000,0
Jamie Devitt,Newport County,150000,Wypożyczenie,GB4,2020,150000,0
Jamie Devitt,Bradford City,150000,Wypożyczenie,GB4,2019,150000,0
Neal Eardley,AFC Barrow,150000,Wypożyczenie,GB4,2020,0,-150000
George Lapslie,Mansfield Town,150000,Wypożyczenie,GB4,2020,150000,0
Odin Bailey,Forest Green Rovers,150000,Wypożyczenie,GB4,2020,250000,100000
Odin Bailey,Forest Green Rovers,150000,Wypożyczenie,GB4,2019,250000,100000
Teddy Howe,Scunthorpe United,150000,Wypożyczenie,GB4,2020,0,-150000
Kyle Taylor,Southend United,100000,Wypożyczenie,GB4,2020,200000,100000
Kyle Taylor,Forest Green Rovers,0,Wypożyczenie,GB4,2019,200000,200000
Ian Lawlor,Oldham Athletic,100000,Wypożyczenie,GB4,2020,100000,0
Ian Lawlor,Scunthorpe United,100000,Wypożyczenie,GB4,2019,100000,0
Aramide Oteh,FC Stevenage,100000,Wypożyczenie,GB4,2020,100000,0
Aramide Oteh,Colchester United,100000,Wypożyczenie,GB4,2020,100000,0
Aramide Oteh,Bradford City,100000,Wypożyczenie,GB4,2019,100000,0
Aramide Oteh,FC Walsall,100000,Wypożyczenie,GB3,2018,100000,0
Sam Smith,Cheltenham Town,100000,Wypożyczenie,GB4,2020,500000,400000
Sam Smith,Tranmere Rovers,100000,Wypożyczenie,GB4,2020,500000,400000
Sam Smith,Cambridge United,100000,Wypożyczenie,GB4,2019,500000,400000
Sam Smith,Oxford United,100000,Wypożyczenie,GB3,2018,500000,400000
Sam Smith,Shrewsbury Town,100000,Wypożyczenie,GB3,2018,500000,400000
Jordan Green,Southend United,100000,Wypożyczenie,GB4,2020,100000,0
Jordan Green,Newport County,100000,Wypożyczenie,GB4,2019,100000,0
Oliver Sarkic,Mansfield Town,100000,Wypożyczenie,GB4,2020,200000,100000
Tom Sang,Cheltenham Town,100000,Wypożyczenie,GB4,2020,300000,200000
Anthony Hartigan,Newport County,50000,Wypożyczenie,GB4,2020,50000,0
Connor Malley,Carlisle United,50000,Wypożyczenie,GB4,2020,50000,0
Josh Doherty,Colchester United,50000,Wypożyczenie,GB4,2020,0,-50000
Zack Elbouzedi,Bolton Wanderers,50000,Wypożyczenie,GB4,2020,300000,250000
Dan Jones,Harrogate Town,0,Wypożyczenie,GB4,2020,150000,150000
Dan Jones,Harrogate Town,0,Wypożyczenie,GB4,2020,0,0
Marcus Maddison,Bolton Wanderers,0,Wypożyczenie,GB4,2020,0,0
Marcus Maddison,Hull City,750000,Wypożyczenie,GB2,2019,0,-750000
Bobby Grant,Oldham Athletic,0,Wypożyczenie,GB4,2020,0,0
Bobby Grant,Accrington Stanley,0,Wypożyczenie,GB3,2019,0,0
Kyle Bennett,Grimsby Town,0,Wypożyczenie,GB4,2020,0,0
Kyle Bennett,Swindon Town,0,Wypożyczenie,GB4,2018,0,0
George Taft,Scunthorpe United,0,Wypożyczenie,GB4,2020,0,0
Virgil Gomis,Grimsby Town,0,Wypożyczenie,GB4,2020,0,0
Virgil Gomis,Macclesfield Town FC,0,Wypożyczenie,GB4,2019,0,0
Virgil Gomis,Notts County,0,Wypożyczenie,GB4,2018,0,0
Andy Cook,Bradford City,0,Wypożyczenie,GB4,2020,50000,50000
Andy Cook,Tranmere Rovers,0,Wypożyczenie,GB3,2019,50000,50000
Paul Coutts,Salford City,0,Wypożyczenie,GB4,2020,150000,150000
Bryce Hosannah,Bradford City,0,Wypożyczenie,GB4,2020,0,0
Rumarn Burrell,Bradford City,0,Wypożyczenie,GB4,2020,0,0
Jake Taylor,Scunthorpe United,0,Wypożyczenie,GB4,2020,100000,100000
Jake Taylor,Port Vale FC,0,Wypożyczenie,GB4,2019,100000,100000
Jahmal Hector-Ingram,FC Stevenage,0,Wypożyczenie,GB4,2020,0,0
Alex Denny,FC Morecambe,0,Wypożyczenie,GB4,2020,50000,50000
Tyler Cordner,Scunthorpe United,0,Wypożyczenie,GB4,2020,0,0
Tyler Cordner,Southend United,0,Wypożyczenie,GB4,2020,0,0
Tunji Akinola,Leyton Orient,0,Wypożyczenie,GB4,2020,175000,175000
Aaron Lewis,Newport County,0,Wypożyczenie,GB4,2020,0,0
Aaron Lewis,Doncaster Rovers,0,Wypożyczenie,GB3,2018,0,0
William Hondermarck,Harrogate Town,0,Wypożyczenie,GB4,2020,200000,200000
Harrison Biggins,AFC Barrow,0,Wypożyczenie,GB4,2020,0,0
Ben Garrity,Oldham Athletic,0,Wypożyczenie,GB4,2020,300000,300000
Martell Taylor-Crossdale,Colchester United,0,Wypożyczenie,GB4,2020,0,0
Aji Alese,Cambridge United,0,Wypożyczenie,GB4,2020,1000000,1000000
Aji Alese,Accrington Stanley,0,Wypożyczenie,GB3,2019,1000000,1000000
Reeco Hackett,Southend United,0,Wypożyczenie,GB4,2020,200000,200000
Dan Bramall,AFC Barrow,0,Wypożyczenie,GB4,2020,0,0
Ethan Walker,Carlisle United,0,Wypożyczenie,GB4,2020,200000,200000
Oladapo Afolayan,Bolton Wanderers,0,Wypożyczenie,GB4,2020,800000,800000
Oladapo Afolayan,Mansfield Town,0,Wypożyczenie,GB4,2019,800000,800000
Oladapo Afolayan,Oldham Athletic,0,Wypożyczenie,GB4,2018,800000,800000
Mitchell Clark,Port Vale FC,0,Wypożyczenie,GB4,2020,250000,250000
Mitchell Clark,Port Vale FC,0,Wypożyczenie,GB4,2019,250000,250000
Mitchell Clark,Port Vale FC,0,Wypożyczenie,GB4,2018,250000,250000
Jayden Reid,AFC Barrow,0,Wypożyczenie,GB4,2020,100000,100000
Jayden Reid,FC Walsall,0,Wypożyczenie,GB4,2020,100000,100000
Scott Twine,Newport County,0,Wypożyczenie,GB4,2020,2000000,2000000
Mustapha Olagunju,Port Vale FC,0,Wypożyczenie,GB4,2020,0,0
Calum MacDonald,Tranmere Rovers,0,Wypożyczenie,GB4,2020,0,0
Remeao Hutton,FC Stevenage,0,Wypożyczenie,GB4,2020,0,0
Bradley Webb,Newport County,0,Wypożyczenie,GB4,2020,0,0
Micah Obiero,Carlisle United,0,Wypożyczenie,GB4,2020,0,0
James Montgomery,Southend United,0,Wypożyczenie,GB4,2020,0,0
Jubril Okedina,Cambridge United,0,Wypożyczenie,GB4,2020,700000,700000
Jamie Pardington,Mansfield Town,0,Wypożyczenie,GB4,2020,0,0
Ryan Cooney,FC Morecambe,0,Wypożyczenie,GB4,2020,250000,250000
Ryan Cooney,FC Morecambe,0,Wypożyczenie,GB4,2019,250000,250000
Jordan Thomas,Leyton Orient,0,Wypożyczenie,GB4,2020,0,0
Jordan Maguire-Drew,Crawley Town,0,Wypożyczenie,GB4,2020,0,0
George Nurse,FC Walsall,0,Wypożyczenie,GB4,2020,300000,300000
George Nurse,Newport County,0,Wypożyczenie,GB4,2019,300000,300000
Danny Preston,Grimsby Town,0,Wypożyczenie,GB4,2020,0,0
Nya Kirby,Tranmere Rovers,0,Wypożyczenie,GB4,2020,300000,300000
Nya Kirby,FC Blackpool,0,Wypożyczenie,GB3,2018,300000,300000
Billy Crellin,Bolton Wanderers,0,Wypożyczenie,GB4,2020,0,0
Joe Adams,Grimsby Town,0,Wypożyczenie,GB4,2020,100000,100000
Austin Samuels,Bradford City,0,Wypożyczenie,GB4,2020,175000,175000
Elliot Bonds,Cheltenham Town,0,Wypożyczenie,GB4,2020,250000,250000
Marcus Dewhurst,Carlisle United,0,Wypożyczenie,GB4,2020,0,0
Marcus Dewhurst,Carlisle United,0,Wypożyczenie,GB4,2019,0,0
Adan George,FC Walsall,0,Wypożyczenie,GB4,2020,100000,100000
Josh March,Harrogate Town,0,Wypożyczenie,GB4,2020,150000,150000
Tom White,Bolton Wanderers,0,Wypożyczenie,GB4,2020,0,0
Frank Vincent,FC Walsall,0,Wypożyczenie,GB4,2020,0,0
Frank Vincent,Scunthorpe United,0,Wypożyczenie,GB4,2020,0,0
Terry Taylor,Grimsby Town,0,Wypożyczenie,GB4,2020,250000,250000
Arthur Read,FC Stevenage,0,Wypożyczenie,GB4,2020,0,0
Jayden Richardson,Forest Green Rovers,0,Wypożyczenie,GB4,2020,400000,400000
Jayden Richardson,Exeter City,0,Wypożyczenie,GB4,2019,400000,400000
Serhat Tasdemir,Oldham Athletic,0,Wypożyczenie,GB4,2020,0,0
James Olayinka,Southend United,0,Wypożyczenie,GB4,2020,0,0
James Olayinka,Northampton Town,0,Wypożyczenie,GB4,2019,0,0
Tom McGill,Crawley Town,0,Wypożyczenie,GB4,2020,200000,200000
Tom McGill,Crawley Town,0,Wypożyczenie,GB4,2019,200000,200000
Hélder Costa,Leeds United,15000000,Wypożyczenie,GB2,2019,3000000,-12000000
Jean-Kévin Augustin,Leeds United,14000000,Wypożyczenie,GB2,2019,1000000,-13000000
Terence Kongolo,FC Fulham,12000000,Wypożyczenie,GB2,2019,900000,-11100000
Bobby De Cordova-Reid,FC Fulham,10000000,Wypożyczenie,GB2,2019,7000000,-3000000
Eddie Nketiah,Leeds United,8000000,Wypożyczenie,GB2,2019,25000000,17000000
Adama Diakhaby,Nottingham Forest,8000000,Wypożyczenie,GB2,2019,800000,-7200000
Callum Robinson,West Bromwich Albion,7000000,Wypożyczenie,GB2,2019,3000000,-4000000
Jacob Murphy,Sheffield Wednesday,6000000,Wypożyczenie,GB2,2019,10000000,4000000
Ryan Woods,FC Millwall,5000000,Wypożyczenie,GB2,2019,2000000,-3000000
Ryan Woods,Stoke City,2000000,Wypożyczenie,GB2,2018,2000000,0
Illan Meslier,Leeds United,5000000,Wypożyczenie,GB2,2019,22000000,17000000
Grady Diangana,West Bromwich Albion,5000000,Wypożyczenie,GB2,2019,6000000,1000000
Markus Henriksen,Bristol City,5000000,Wypożyczenie,GB2,2019,1000000,-4000000
Jonas Lössl,Huddersfield Town,5000000,Wypożyczenie,GB2,2019,600000,-4400000
James Chester,Stoke City,4000000,Wypożyczenie,GB2,2019,500000,-3500000
Pelé,FC Reading,4000000,Wypożyczenie,GB2,2019,800000,-3200000
Pelé,Nottingham Forest,6000000,Wypożyczenie,GB2,2018,800000,-5200000
Rhian Brewster,Swansea City,4000000,Wypożyczenie,GB2,2019,5000000,1000000
Harold Moukoudi,FC Middlesbrough,4000000,Wypożyczenie,GB2,2019,4000000,0
Nahki Wells,Queens Park Rangers,4000000,Wypożyczenie,GB2,2019,1000000,-3000000
Nahki Wells,Queens Park Rangers,4000000,Wypożyczenie,GB2,2018,1000000,-3000000
Albert Adomah,Cardiff City,3000000,Wypożyczenie,GB2,2019,250000,-2750000
Tosin Adarabioyo,Blackburn Rovers,3000000,Wypożyczenie,GB2,2019,15000000,12000000
Tosin Adarabioyo,West Bromwich Albion,1000000,Wypożyczenie,GB2,2018,15000000,14000000
Kieran Dowell,Wigan Athletic,3000000,Wypożyczenie,GB2,2019,2000000,-1000000
Kieran Dowell,Derby County,3000000,Wypożyczenie,GB2,2019,2000000,-1000000
Kieran Dowell,Sheffield United,3000000,Wypożyczenie,GB2,2018,2000000,-1000000
Scott Hogan,Birmingham City,3000000,Wypożyczenie,GB2,2019,2000000,-1000000
Scott Hogan,Stoke City,3000000,Wypożyczenie,GB2,2019,2000000,-1000000
Scott Hogan,Sheffield United,5000000,Wypożyczenie,GB2,2018,2000000,-3000000
Greg Cunningham,Blackburn Rovers,3000000,Wypożyczenie,GB2,2019,350000,-2650000
Rafa Mir,Nottingham Forest,3000000,Wypożyczenie,GB2,2019,10000000,7000000
Trevoh Chalobah,Huddersfield Town,3000000,Wypożyczenie,GB2,2019,22000000,19000000
Trevoh Chalobah,Ipswich Town,0,Wypożyczenie,GB2,2018,22000000,22000000
Matt Miazga,FC Reading,3000000,Wypożyczenie,GB2,2019,2000000,-1000000
Matt Miazga,FC Reading,3000000,Wypożyczenie,GB2,2018,2000000,-1000000
Emile Smith Rowe,Huddersfield Town,3000000,Wypożyczenie,GB2,2019,38000000,35000000
Aiden McGeady,Charlton Athletic,2000000,Wypożyczenie,GB2,2019,300000,-1700000
Connor Wickham,Sheffield Wednesday,2000000,Wypożyczenie,GB2,2019,800000,-1200000
Andy King,Huddersfield Town,2000000,Wypożyczenie,GB2,2019,300000,-1700000
Andy King,Derby County,3000000,Wypożyczenie,GB2,2018,300000,-2700000
Alessio Da Cruz,Sheffield Wednesday,2000000,Wypożyczenie,GB2,2019,1000000,-1000000
Arijanet Muric,Nottingham Forest,2000000,Wypożyczenie,GB2,2019,6000000,4000000
Jan Mlakar,Queens Park Rangers,2000000,Wypożyczenie,GB2,2019,2000000,0
Jan Mlakar,Wigan Athletic,2000000,Wypożyczenie,GB2,2019,2000000,0
David Bates,Sheffield Wednesday,2000000,Wypożyczenie,GB2,2019,650000,-1350000
Harrison Reed,FC Fulham,2000000,Wypożyczenie,GB2,2019,15000000,13000000
Harrison Reed,Blackburn Rovers,1000000,Wypożyczenie,GB2,2018,15000000,14000000
Conor Gallagher,Swansea City,2000000,Wypożyczenie,GB2,2019,32000000,30000000
Conor Gallagher,Charlton Athletic,0,Wypożyczenie,GB2,2019,32000000,32000000
Andre Green,Charlton Athletic,2000000,Wypożyczenie,GB2,2019,750000,-1250000
Andre Green,Preston North End,2000000,Wypożyczenie,GB2,2019,750000,-1250000
Andre Green,FC Portsmouth,1000000,Wypożyczenie,GB3,2018,750000,-250000
Pedro Pereira,Bristol City,2000000,Wypożyczenie,GB2,2019,2000000,0
Jamie Paterson,Derby County,2000000,Wypożyczenie,GB2,2019,900000,-1100000
Josh Windass,Sheffield Wednesday,2000000,Wypożyczenie,GB2,2019,600000,-1400000
Lucas Boyé,FC Reading,1000000,Wypożyczenie,GB2,2019,6000000,5000000
Chris Willock,West Bromwich Albion,1000000,Wypożyczenie,GB2,2019,4000000,3000000
Chris Willock,Huddersfield Town,1000000,Wypożyczenie,GB2,2019,4000000,3000000
Ben Wilmot,Swansea City,1000000,Wypożyczenie,GB2,2019,6000000,5000000
Mason Bennett,FC Millwall,1000000,Wypożyczenie,GB2,2019,1000000,0
Leon Balogun,Wigan Athletic,1000000,Wypożyczenie,GB2,2019,400000,-600000
Beram Kayal,Charlton Athletic,1000000,Wypożyczenie,GB2,2019,300000,-700000
Brad Smith,Cardiff City,1000000,Wypożyczenie,GB2,2019,1000000,0
Rushian Hepburn-Murphy,Derby County,1000000,Wypożyczenie,GB2,2019,200000,-800000
Rushian Hepburn-Murphy,Tranmere Rovers,1000000,Wypożyczenie,GB3,2019,200000,-800000
Rushian Hepburn-Murphy,Cambridge United,1000000,Wypożyczenie,GB4,2018,200000,-800000
John Bostock,Nottingham Forest,1000000,Wypożyczenie,GB2,2019,0,-1000000
Jefferson Montero,Birmingham City,1000000,Wypożyczenie,GB2,2019,250000,-750000
Jefferson Montero,West Bromwich Albion,1000000,Wypożyczenie,GB2,2018,250000,-750000
James Bree,Luton Town,1000000,Wypożyczenie,GB2,2019,3000000,2000000
James Bree,Ipswich Town,1000000,Wypożyczenie,GB2,2018,3000000,2000000
Josh Cullen,Charlton Athletic,1000000,Wypożyczenie,GB2,2019,10000000,9000000
Josh Cullen,Charlton Athletic,1000000,Wypożyczenie,GB3,2018,10000000,9000000
Mallik Wilks,Hull City,900000,Wypożyczenie,GB2,2019,800000,-100000
Mallik Wilks,Doncaster Rovers,0,Wypożyczenie,GB3,2018,800000,800000
Ovie Ejaria,FC Reading,900000,Wypożyczenie,GB2,2019,2000000,1100000
Ovie Ejaria,FC Reading,900000,Wypożyczenie,GB2,2018,2000000,1100000
Ravel Morrison,FC Middlesbrough,750000,Wypożyczenie,GB2,2019,500000,-250000
Aldo Kalulu,Swansea City,750000,Wypożyczenie,GB2,2019,1000000,250000
David Davis,Charlton Athletic,750000,Wypożyczenie,GB2,2019,250000,-500000
Bartosz Bialkowski,FC Millwall,750000,Wypożyczenie,GB2,2019,250000,-500000
Ayub Masika,FC Reading,650000,Wypożyczenie,GB2,2019,350000,-300000
Eunan O'Kane,Luton Town,500000,Wypożyczenie,GB2,2019,0,-500000
Eunan O'Kane,Luton Town,750000,Wypożyczenie,GB3,2018,0,-750000
João Virgínia,FC Reading,500000,Wypożyczenie,GB2,2019,700000,200000
Ben Hamer,Derby County,500000,Wypożyczenie,GB2,2019,250000,-250000
Mark Duffy,Stoke City,500000,Wypożyczenie,GB2,2019,0,-500000
Bright Enobakhare,Wigan Athletic,500000,Wypożyczenie,GB2,2019,200000,-300000
Bright Enobakhare,Coventry City,500000,Wypożyczenie,GB3,2018,200000,-300000
Kamil Grabara,Huddersfield Town,400000,Wypożyczenie,GB2,2019,5000000,4600000
Kilian Ludewig,FC Barnsley,300000,Wypożyczenie,GB2,2019,500000,200000
Luke Steele,FC Millwall,150000,Wypożyczenie,GB2,2019,0,-150000
Luke Amos,Queens Park Rangers,100000,Wypożyczenie,GB2,2019,500000,400000
Alexandru Dobre,Wigan Athletic,100000,Wypożyczenie,GB2,2019,1000000,900000
Alexandru Dobre,Yeovil Town,100000,Wypożyczenie,GB4,2018,1000000,900000
Moha Ramos,Birmingham City,50000,Wypożyczenie,GB2,2019,25000,-25000
Ben White,Leeds United,0,Wypożyczenie,GB2,2019,50000000,50000000
Ben White,Peterborough United,0,Wypożyczenie,GB3,2018,50000000,50000000
Sam Surridge,Swansea City,0,Wypożyczenie,GB2,2019,3000000,3000000
Sam Surridge,Oldham Athletic,0,Wypożyczenie,GB4,2018,3000000,3000000
Luke Bolton,Luton Town,0,Wypożyczenie,GB2,2019,2000000,2000000
Luke Bolton,Wycombe Wanderers,0,Wypożyczenie,GB3,2018,2000000,2000000
Rocky Bushiri,FC Blackpool,1000000,Wypożyczenie,GB3,2019,400000,-600000
Liam Bridcutt,Lincoln City,1000000,Wypożyczenie,GB3,2019,250000,-750000
Liam Bridcutt,Bolton Wanderers,1000000,Wypożyczenie,GB3,2019,250000,-750000
Cameron Borthwick-Jackson,Tranmere Rovers,1000000,Wypożyczenie,GB3,2019,300000,-700000
Cameron Borthwick-Jackson,Oldham Athletic,1000000,Wypożyczenie,GB4,2019,300000,-700000
Cameron Borthwick-Jackson,Scunthorpe United,3000000,Wypożyczenie,GB3,2018,300000,-2700000
George Thorne,Oxford United,1000000,Wypożyczenie,GB3,2019,0,-1000000
George Thorne,Luton Town,1000000,Wypożyczenie,GB3,2018,0,-1000000
Ross McCrorie,FC Portsmouth,1000000,Wypożyczenie,GB3,2019,750000,-250000
James Husband,FC Blackpool,1000000,Wypożyczenie,GB3,2019,600000,-400000
James Husband,Fleetwood Town,1000000,Wypożyczenie,GB3,2018,600000,-400000
Marc McNulty,AFC Sunderland,1000000,Wypożyczenie,GB3,2019,500000,-500000
Laurens De Bock,AFC Sunderland,1000000,Wypożyczenie,GB3,2019,600000,-400000
Luke Garbutt,Ipswich Town,750000,Wypożyczenie,GB3,2019,300000,-450000
Luke Garbutt,Oxford United,1000000,Wypożyczenie,GB3,2018,300000,-700000
Marcus Browne,Oxford United,750000,Wypożyczenie,GB3,2019,300000,-450000
Marcus Browne,Oxford United,250000,Wypożyczenie,GB3,2018,300000,50000
Max O'Leary,Shrewsbury Town,750000,Wypożyczenie,GB3,2019,800000,50000
Toto Nsiala,Bolton Wanderers,750000,Wypożyczenie,GB3,2019,300000,-450000
Chris Cadden,Oxford United,700000,Wypożyczenie,GB3,2019,650000,-50000
Conor McAleny,Shrewsbury Town,500000,Wypożyczenie,GB3,2019,400000,-100000
Connor Ronan,FC Blackpool,500000,Wypożyczenie,GB3,2019,800000,300000
Connor Ronan,FC Walsall,250000,Wypożyczenie,GB3,2018,800000,550000
Rolando Aarons,Wycombe Wanderers,500000,Wypożyczenie,GB3,2019,300000,-200000
Rolando Aarons,Sheffield Wednesday,500000,Wypożyczenie,GB2,2018,300000,-200000
Marc Bola,FC Blackpool,500000,Wypożyczenie,GB3,2019,1000000,500000
Ben Heneghan,FC Blackpool,500000,Wypożyczenie,GB3,2019,300000,-200000
Ben Heneghan,FC Blackpool,400000,Wypożyczenie,GB3,2018,300000,-100000
Antoine Semenyo,AFC Sunderland,500000,Wypożyczenie,GB3,2019,9000000,8500000
Antoine Semenyo,Newport County,0,Wypożyczenie,GB4,2018,9000000,9000000
Jason McCarthy,Wycombe Wanderers,500000,Wypożyczenie,GB3,2019,350000,-150000
James Vaughan,Tranmere Rovers,500000,Wypożyczenie,GB3,2019,0,-500000
James Vaughan,FC Portsmouth,500000,Wypożyczenie,GB3,2018,0,-500000
Cameron McGeehan,FC Portsmouth,500000,Wypożyczenie,GB3,2019,600000,100000
Jordan Rossiter,Fleetwood Town,450000,Wypożyczenie,GB3,2019,250000,-200000
Jordan Rossiter,FC Bury,450000,Wypożyczenie,GB4,2018,250000,-200000
Jake Hastie,Rotherham United,450000,Wypożyczenie,GB3,2019,250000,-200000
Courtney Baker-Richardson,Accrington Stanley,350000,Wypożyczenie,GB3,2019,300000,-50000
Mads Bech Sörensen,AFC Wimbledon,350000,Wypożyczenie,GB3,2019,4000000,3650000
Jimmy Dunne,Fleetwood Town,300000,Wypożyczenie,GB3,2019,3000000,2700000
Jimmy Dunne,AFC Sunderland,300000,Wypożyczenie,GB3,2018,3000000,2700000
Lewie Coyle,Fleetwood Town,250000,Wypożyczenie,GB3,2019,800000,550000
Josh Ginnelly,Bristol Rovers,250000,Wypożyczenie,GB3,2019,700000,450000
Sean Raggett,FC Portsmouth,250000,Wypożyczenie,GB3,2019,350000,100000
Sean Raggett,Rotherham United,250000,Wypożyczenie,GB2,2018,350000,100000
Conor Shaughnessy,Burton Albion,250000,Wypożyczenie,GB3,2019,250000,0
Conor Shaughnessy,Mansfield Town,250000,Wypożyczenie,GB4,2019,250000,0
Kean Bryan,Bolton Wanderers,250000,Wypożyczenie,GB3,2019,900000,650000
Mikael Ndjoli,FC Gillingham,250000,Wypożyczenie,GB3,2019,0,-250000
Jordan Graham,FC Gillingham,250000,Wypożyczenie,GB3,2019,300000,50000
Jordan Graham,Ipswich Town,500000,Wypożyczenie,GB2,2018,300000,-200000
Jordan Graham,Oxford United,500000,Wypożyczenie,GB3,2018,300000,-200000
Donervon Daniels,Doncaster Rovers,250000,Wypożyczenie,GB3,2019,300000,50000
Jak Alnwick,FC Blackpool,250000,Wypożyczenie,GB3,2019,400000,150000
Jak Alnwick,Scunthorpe United,250000,Wypożyczenie,GB3,2018,400000,150000
Sam Hart,Shrewsbury Town,250000,Wypożyczenie,GB3,2019,250000,0
Sam Hart,AFC Rochdale,100000,Wypożyczenie,GB3,2018,250000,150000
Sam Hart,Southend United,100000,Wypożyczenie,GB3,2018,250000,150000
Thibaud Verlinden,Bolton Wanderers,250000,Wypożyczenie,GB3,2019,600000,350000
Kane Wilson,Tranmere Rovers,250000,Wypożyczenie,GB3,2019,300000,50000
Kane Wilson,FC Walsall,250000,Wypożyczenie,GB3,2018,300000,50000
Kane Wilson,Exeter City,250000,Wypożyczenie,GB4,2018,300000,50000
Jason Lokilo,Doncaster Rovers,200000,Wypożyczenie,GB3,2019,550000,350000
Harry Souttar,Fleetwood Town,200000,Wypożyczenie,GB3,2019,15000000,14800000
Harry Souttar,Fleetwood Town,200000,Wypożyczenie,GB3,2018,15000000,14800000
Seny Dieng,Doncaster Rovers,150000,Wypożyczenie,GB3,2019,1000000,850000
Seny Dieng,FC Stevenage,100000,Wypożyczenie,GB4,2018,1000000,900000
Jordan Roberts,FC Gillingham,150000,Wypożyczenie,GB3,2019,300000,150000
Jordan Roberts,Lincoln City,100000,Wypożyczenie,GB4,2018,300000,200000
Sammie Szmodics,Peterborough United,150000,Wypożyczenie,GB3,2019,1000000,850000
Benny Ashley-Seal,Accrington Stanley,150000,Wypożyczenie,GB3,2019,50000,-100000
Tennai Watson,Coventry City,150000,Wypożyczenie,GB3,2019,150000,0
Tennai Watson,AFC Wimbledon,100000,Wypożyczenie,GB3,2018,150000,50000
Jake Wright,Bolton Wanderers,150000,Wypożyczenie,GB3,2019,0,-150000
Patrik Gunnarsson,Southend United,150000,Wypożyczenie,GB3,2019,700000,550000
Alfie Jones,FC Gillingham,100000,Wypożyczenie,GB3,2019,0,-100000
Alfie Jones,FC Gillingham,100000,Wypożyczenie,GB3,2019,1000000,900000
Victor Adeboyejo,Bristol Rovers,100000,Wypożyczenie,GB3,2019,400000,300000
Victor Adeboyejo,Cambridge United,100000,Wypożyczenie,GB4,2019,400000,300000
Connor Simpson,Accrington Stanley,100000,Wypożyczenie,GB3,2019,0,-100000
Connor Simpson,Carlisle United,0,Wypożyczenie,GB4,2018,0,0
Callum Lang,Shrewsbury Town,100000,Wypożyczenie,GB3,2019,1000000,900000
Callum Lang,Oldham Athletic,0,Wypożyczenie,GB4,2018,1000000,1000000
Alex Jakubiak,FC Gillingham,100000,Wypożyczenie,GB3,2019,150000,50000
Alex Jakubiak,Bristol Rovers,100000,Wypożyczenie,GB3,2018,150000,50000
Anthony Georgiou,Ipswich Town,50000,Wypożyczenie,GB3,2019,300000,250000
Anthony Georgiou,Bolton Wanderers,50000,Wypożyczenie,GB3,2019,300000,250000
Aaron Chapman,Tranmere Rovers,25000,Wypożyczenie,GB3,2019,0,-25000
Alex Woodyard,Tranmere Rovers,25000,Wypożyczenie,GB3,2019,25000,0
Ethan Hamilton,Southend United,0,Wypożyczenie,GB3,2019,500000,500000
Ethan Hamilton,Bolton Wanderers,0,Wypożyczenie,GB3,2019,500000,500000
Ethan Hamilton,AFC Rochdale,0,Wypożyczenie,GB3,2018,500000,500000
Sadou Diallo,Accrington Stanley,0,Wypożyczenie,GB3,2019,75000,75000
Layton Ndukwu,Southend United,0,Wypożyczenie,GB3,2019,100000,100000
Robert Sánchez,AFC Rochdale,0,Wypożyczenie,GB3,2019,32000000,32000000
Robert Sánchez,Forest Green Rovers,0,Wypożyczenie,GB4,2018,32000000,32000000
Morgan Feeney,Tranmere Rovers,0,Wypożyczenie,GB3,2019,0,0
Callum O'Hare,Coventry City,0,Wypożyczenie,GB3,2019,4000000,4000000
Callum O'Hare,Carlisle United,0,Wypożyczenie,GB4,2018,4000000,4000000
Dan Barlaser,Rotherham United,0,Wypożyczenie,GB3,2019,2000000,2000000
Dan Barlaser,Accrington Stanley,0,Wypożyczenie,GB3,2018,2000000,2000000
Nathan Trott,AFC Wimbledon,0,Wypożyczenie,GB3,2019,400000,400000
Andy Fisher,Milton Keynes Dons,0,Wypożyczenie,GB3,2019,500000,500000
Andy Fisher,Northampton Town,0,Wypożyczenie,GB4,2019,500000,500000
Joe Morrell,Lincoln City,0,Wypożyczenie,GB3,2019,500000,500000
Jacob Ramsey,Doncaster Rovers,0,Wypożyczenie,GB3,2019,32000000,32000000
Ísak Snaer Thorvaldsson,Fleetwood Town,0,Wypożyczenie,GB3,2019,400000,400000
Giles Phillips,Wycombe Wanderers,0,Wypożyczenie,GB3,2019,0,0
Michael Folivi,AFC Wimbledon,0,Wypożyczenie,GB3,2019,0,0
Michael Folivi,AFC Wimbledon,0,Wypożyczenie,GB3,2018,0,0
Max Sanders,AFC Wimbledon,0,Wypożyczenie,GB3,2019,200000,200000
Jordan Ponticelli,Tranmere Rovers,0,Wypożyczenie,GB3,2019,0,0
Jordan Ponticelli,Macclesfield Town FC,0,Wypożyczenie,GB4,2018,0,0
Julien Lamy,AFC Wimbledon,0,Wypożyczenie,GB3,2019,150000,150000
Cameron John,Doncaster Rovers,0,Wypożyczenie,GB3,2019,0,0
Ousseynou Cissé,Leyton Orient,700000,Wypożyczenie,GB4,2019,0,-700000
Eoin Doyle,Swindon Town,650000,Wypożyczenie,GB4,2019,300000,-350000
Zak Rudden,Plymouth Argyle,400000,Wypożyczenie,GB4,2019,300000,-100000
Glenn Middleton,Bradford City,400000,Wypożyczenie,GB4,2019,500000,100000
Jack Baldwin,Salford City,400000,Wypożyczenie,GB4,2019,400000,0
Rob Hall,Forest Green Rovers,400000,Wypożyczenie,GB4,2019,0,-400000
Filipe Morais,Oldham Athletic,350000,Wypożyczenie,GB4,2019,0,-350000
Gavin Reilly,Cheltenham Town,350000,Wypożyczenie,GB4,2019,0,-350000
Mark Howard,Salford City,300000,Wypożyczenie,GB4,2019,0,-300000
Tom Nichols,Cheltenham Town,300000,Wypożyczenie,GB4,2019,300000,0
Nathan Thomas,Carlisle United,250000,Wypożyczenie,GB4,2019,0,-250000
Nathan Thomas,Notts County,250000,Wypożyczenie,GB4,2018,0,-250000
Nathan Thomas,Carlisle United,250000,Wypożyczenie,GB4,2018,0,-250000
Tafari Moore,Colchester United,200000,Wypożyczenie,GB4,2019,0,-200000
Theo Robinson,Colchester United,200000,Wypożyczenie,GB4,2019,0,-200000
Theo Robinson,Swindon Town,200000,Wypożyczenie,GB4,2018,0,-200000
Chuma Anene,Crewe Alexandra,200000,Wypożyczenie,GB4,2019,0,-200000
Anthony Grant,Swindon Town,200000,Wypożyczenie,GB4,2019,200000,0
Ryan Inniss,Newport County,150000,Wypożyczenie,GB4,2019,150000,0
Rory Gaffney,FC Walsall,150000,Wypożyczenie,GB4,2019,100000,-50000
Ashley Hunter,Salford City,150000,Wypożyczenie,GB4,2019,150000,0
Junior Brown,Scunthorpe United,150000,Wypożyczenie,GB4,2019,0,-150000
Jake Jervis,Salford City,150000,Wypożyczenie,GB4,2019,250000,100000
Jake Jervis,AFC Wimbledon,150000,Wypożyczenie,GB3,2018,250000,100000
Connor Kirby,Macclesfield Town FC,100000,Wypożyczenie,GB4,2019,0,-100000
Christoffer Mafoumbi,FC Morecambe,100000,Wypożyczenie,GB4,2019,100000,0
Rory Holden,FC Walsall,100000,Wypożyczenie,GB4,2019,100000,0
Rory Holden,AFC Rochdale,0,Wypożyczenie,GB3,2018,100000,100000
Jerry Yates,Swindon Town,100000,Wypożyczenie,GB4,2019,3000000,2900000
Jerry Yates,Carlisle United,100000,Wypożyczenie,GB4,2018,3000000,2900000
Jack Rose,FC Walsall,100000,Wypożyczenie,GB4,2019,100000,0
George Cooper,Plymouth Argyle,100000,Wypożyczenie,GB4,2019,0,-100000
Callum Cooke,Bradford City,100000,Wypożyczenie,GB4,2019,100000,0
Scott Wharton,Northampton Town,100000,Wypożyczenie,GB4,2019,1000000,900000
Scott Wharton,Lincoln City,100000,Wypożyczenie,GB4,2018,1000000,900000
Scott Wharton,FC Bury,100000,Wypożyczenie,GB4,2018,1000000,900000
Josh Dacres-Cogley,Crawley Town,100000,Wypożyczenie,GB4,2019,200000,100000
Otis Khan,Newport County,75000,Wypożyczenie,GB4,2019,75000,0
Gregor Zabret,Oldham Athletic,75000,Wypożyczenie,GB4,2019,75000,0
Carl Piergianni,Oldham Athletic,50000,Wypożyczenie,GB4,2019,50000,0
Adam May,Swindon Town,50000,Wypożyczenie,GB4,2019,300000,250000
Owen Evans,Macclesfield Town FC,50000,Wypożyczenie,GB4,2019,50000,0
Owen Evans,Cheltenham Town,50000,Wypożyczenie,GB4,2019,50000,0
Emmanuel Dieseruvwe,Oldham Athletic,50000,Wypożyczenie,GB4,2019,0,-50000
Ashley Smith-Brown,Oldham Athletic,0,Wypożyczenie,GB4,2019,0,0
Paul Mullin,Cambridge United,0,Wypożyczenie,GB4,2019,0,0
Shaun Miller,FC Morecambe,0,Wypożyczenie,GB4,2019,0,0
Dale Gorman,Newport County,0,Wypożyczenie,GB4,2019,0,0
Cameron Burgess,Salford City,0,Wypożyczenie,GB4,2019,500000,500000
Conrad Logan,Forest Green Rovers,0,Wypożyczenie,GB4,2019,0,0
Canice Carroll,Carlisle United,0,Wypożyczenie,GB4,2019,0,0
Canice Carroll,Swindon Town,0,Wypożyczenie,GB4,2018,0,0
Mason Bloomfield,Crawley Town,0,Wypożyczenie,GB4,2019,0,0
Billy Waters,Newport County,0,Wypożyczenie,GB4,2019,0,0
Billy Waters,Cheltenham Town,0,Wypożyczenie,GB4,2018,0,0
Danny Whitehead,Macclesfield Town FC,0,Wypożyczenie,GB4,2019,0,0
Lloyd Jones,Northampton Town,0,Wypożyczenie,GB4,2019,200000,200000
Lloyd Jones,Plymouth Argyle,100000,Wypożyczenie,GB3,2018,200000,100000
Craig Mackail-Smith,FC Stevenage,0,Wypożyczenie,GB4,2019,0,0
Craig Mackail-Smith,Notts County,0,Wypożyczenie,GB4,2018,0,0
Josh Grant,Plymouth Argyle,0,Wypożyczenie,GB4,2019,250000,250000
Josh Grant,Yeovil Town,0,Wypożyczenie,GB4,2018,250000,250000
Olufela Olomola,Carlisle United,0,Wypożyczenie,GB4,2019,0,0
Olufela Olomola,Yeovil Town,0,Wypożyczenie,GB4,2018,0,0
Josh Benson,Grimsby Town,0,Wypożyczenie,GB4,2019,300000,300000
Jacob Greaves,Cheltenham Town,0,Wypożyczenie,GB4,2019,8000000,8000000
Jack Evans,Mansfield Town,0,Wypożyczenie,GB4,2019,0,0
Michael Luyambula,Crawley Town,0,Wypożyczenie,GB4,2019,0,0
Ryan Loft,Carlisle United,0,Wypożyczenie,GB4,2019,200000,200000
Harvey Bradbury,FC Morecambe,0,Wypożyczenie,GB4,2019,0,0
Luke Burgess,Salford City,0,Wypożyczenie,GB4,2019,0,0
Elias Sörensen,Carlisle United,0,Wypożyczenie,GB4,2019,0,0
Elias Sörensen,FC Blackpool,0,Wypożyczenie,GB3,2018,0,0
Liam Gibson,Grimsby Town,0,Wypożyczenie,GB4,2019,150000,150000
Liam Gibson,Accrington Stanley,0,Wypożyczenie,GB3,2018,150000,150000
Christian N'Guessan,Oldham Athletic,0,Wypożyczenie,GB4,2019,0,0
Jake Doyle-Hayes,Cheltenham Town,0,Wypożyczenie,GB4,2019,500000,500000
Jake Doyle-Hayes,Cambridge United,0,Wypożyczenie,GB4,2018,500000,500000
Nathan Sheron,FC Walsall,0,Wypożyczenie,GB4,2019,0,0
Dylan Connolly,Bradford City,0,Wypożyczenie,GB4,2019,300000,300000
Max Sheaf,Cheltenham Town,0,Wypożyczenie,GB4,2019,0,0
Michael Nottingham,Crewe Alexandra,0,Wypożyczenie,GB4,2019,200000,200000
Taylor Maloney,Newport County,0,Wypożyczenie,GB4,2019,0,0
Ben Folami,FC Stevenage,0,Wypożyczenie,GB4,2019,500000,500000
Danny McNamara,Newport County,0,Wypożyczenie,GB4,2019,3000000,3000000
George Tanner,FC Morecambe,0,Wypożyczenie,GB4,2019,300000,300000
George Tanner,Salford City,0,Wypożyczenie,GB4,2019,300000,300000
Elliot Watt,Carlisle United,0,Wypożyczenie,GB4,2019,0,0
Joe Leesley,FC Stevenage,0,Wypożyczenie,GB4,2019,0,0
Brendan Wiredu,Colchester United,0,Wypożyczenie,GB4,2019,200000,200000
Ben Liddle,Scunthorpe United,0,Wypożyczenie,GB4,2019,0,0
Ben Liddle,Forest Green Rovers,0,Wypożyczenie,GB4,2018,0,0
George Marsh,Leyton Orient,0,Wypożyczenie,GB4,2019,0,0
Sam French,FC Stevenage,0,Wypożyczenie,GB4,2019,0,0
David Parkhouse,FC Stevenage,0,Wypożyczenie,GB4,2019,50000,50000
Eddie Clarke,Macclesfield Town FC,0,Wypożyczenie,GB4,2019,0,0
Jevani Brown,Forest Green Rovers,0,Wypożyczenie,GB4,2019,250000,250000
Tammy Abraham,Aston Villa,10000000,Wypożyczenie,GB2,2018,45000000,35000000
Tom Carroll,Aston Villa,7000000,Wypożyczenie,GB2,2018,1000000,-6000000
Mason Holgate,West Bromwich Albion,7000000,Wypożyczenie,GB2,2018,12000000,5000000
Jordan Rhodes,Norwich City,6000000,Wypożyczenie,GB2,2018,400000,-5600000
Lewis Baker,Leeds United,5000000,Wypożyczenie,GB2,2018,3000000,-2000000
Lewis Baker,FC Reading,5000000,Wypożyczenie,GB2,2018,3000000,-2000000
Léo Bonatini,Nottingham Forest,5000000,Wypożyczenie,GB2,2018,1000000,-4000000
Tomas Kalas,Bristol City,5000000,Wypożyczenie,GB2,2018,1000000,-4000000
Ben Brereton Díaz,Blackburn Rovers,5000000,Wypożyczenie,GB2,2018,16000000,11000000
Ashley Williams,Stoke City,5000000,Wypożyczenie,GB2,2018,0,-5000000
Muhamed Besic,FC Middlesbrough,5000000,Wypożyczenie,GB2,2018,1000000,-4000000
Nélson Oliveira,FC Reading,5000000,Wypożyczenie,GB2,2018,1000000,-4000000
Rajiv van La Parra,FC Middlesbrough,4000000,Wypożyczenie,GB2,2018,300000,-3700000
Gary Madine,Sheffield United,4000000,Wypożyczenie,GB2,2018,400000,-3600000
Sam Byram,Nottingham Forest,4000000,Wypożyczenie,GB2,2018,1000000,-3000000
Yanic Wildschut,Bolton Wanderers,4000000,Wypożyczenie,GB2,2018,400000,-3600000
Mason Mount,Derby County,4000000,Wypożyczenie,GB2,2018,65000000,61000000
Jack Colback,Nottingham Forest,3000000,Wypożyczenie,GB2,2018,800000,-2200000
Tyrone Mings,Aston Villa,3000000,Wypożyczenie,GB2,2018,25000000,22000000
Jack Harrison,Leeds United,3000000,Wypożyczenie,GB2,2018,22000000,19000000
Chris Martin,Hull City,3000000,Wypożyczenie,GB2,2018,300000,-2700000
Saidy Janko,Nottingham Forest,3000000,Wypożyczenie,GB2,2018,1000000,-2000000
Josh Onomah,Sheffield Wednesday,3000000,Wypożyczenie,GB2,2018,2000000,-1000000
Oliver Norwood,Sheffield United,3000000,Wypożyczenie,GB2,2018,3000000,0
Gil Dias,Nottingham Forest,3000000,Wypożyczenie,GB2,2018,2000000,-1000000
Michael Hector,Sheffield Wednesday,3000000,Wypożyczenie,GB2,2018,1000000,-2000000
Cuco Martina,Stoke City,2000000,Wypożyczenie,GB2,2018,300000,-1700000
Tomer Hemed,Queens Park Rangers,2000000,Wypożyczenie,GB2,2018,250000,-1750000
Geoff Cameron,Queens Park Rangers,2000000,Wypożyczenie,GB2,2018,150000,-1850000
Diogo Gonçalves,Nottingham Forest,2000000,Wypożyczenie,GB2,2018,5000000,3000000
Tommy Elphick,Hull City,2000000,Wypożyczenie,GB2,2018,0,-2000000
Marvin Johnson,Sheffield United,2000000,Wypożyczenie,GB2,2018,450000,-1550000
Jonathan Walters,Ipswich Town,2000000,Wypożyczenie,GB2,2018,0,-2000000
Ben Marshall,FC Millwall,1000000,Wypożyczenie,GB2,2018,0,-1000000
Collin Quaner,Ipswich Town,1000000,Wypożyczenie,GB2,2018,0,-1000000
Marc Pugh,Hull City,1000000,Wypożyczenie,GB2,2018,0,-1000000
Gary Gardner,Birmingham City,1000000,Wypożyczenie,GB2,2018,800000,-200000
Saeid Ezatolahi,FC Reading,1000000,Wypożyczenie,GB2,2018,400000,-600000
George Saville,FC Middlesbrough,1000000,Wypożyczenie,GB2,2018,3000000,2000000
Danny Batth,FC Middlesbrough,1000000,Wypożyczenie,GB2,2018,900000,-100000
Lee Evans,Wigan Athletic,1000000,Wypożyczenie,GB2,2018,600000,-400000
Tayo Edun,Ipswich Town,1000000,Wypożyczenie,GB2,2018,600000,-400000
Ryan Leonard,FC Millwall,1000000,Wypożyczenie,GB2,2018,400000,-600000
Will Keane,Ipswich Town,1000000,Wypożyczenie,GB2,2018,1000000,0
Sam McQueen,FC Middlesbrough,1000000,Wypożyczenie,GB2,2018,0,-1000000
Molla Wagué,Nottingham Forest,1000000,Wypożyczenie,GB2,2018,250000,-750000
Emiliano Martínez,FC Reading,1000000,Wypożyczenie,GB2,2018,28000000,27000000
André Moreira,Aston Villa,1000000,Wypożyczenie,GB2,2018,1000000,0
Fikayo Tomori,Derby County,1000000,Wypożyczenie,GB2,2018,45000000,44000000
Achraf Lazaar,Sheffield Wednesday,1000000,Wypożyczenie,GB2,2018,300000,-700000
Omar Bogle,Birmingham City,750000,Wypożyczenie,GB2,2018,600000,-150000
Omar Bogle,FC Portsmouth,500000,Wypożyczenie,GB3,2018,600000,100000
Tom Bradshaw,FC Millwall,750000,Wypożyczenie,GB2,2018,900000,150000
Ben Amos,FC Millwall,750000,Wypożyczenie,GB2,2018,350000,-400000
Alex Pearce,FC Millwall,750000,Wypożyczenie,GB2,2018,250000,-500000
Leon Clarke,Wigan Athletic,750000,Wypożyczenie,GB2,2018,300000,-450000
Dan Burn,Wigan Athletic,750000,Wypożyczenie,GB2,2018,12000000,11250000
Antonee Robinson,Wigan Athletic,500000,Wypożyczenie,GB2,2018,12000000,11500000
Joe Williams,Bolton Wanderers,500000,Wypożyczenie,GB2,2018,1000000,500000
Jonathan Grounds,Bolton Wanderers,500000,Wypożyczenie,GB2,2018,100000,-400000
Callum Elder,Ipswich Town,250000,Wypożyczenie,GB2,2018,800000,550000
Ryan Manning,Rotherham United,250000,Wypożyczenie,GB2,2018,2000000,1750000
Connor Mahoney,Birmingham City,250000,Wypożyczenie,GB2,2018,400000,150000
Jay Dasilva,Bristol City,250000,Wypożyczenie,GB2,2018,2000000,1750000
Dean Henderson,Sheffield United,250000,Wypożyczenie,GB2,2018,22000000,21750000
Harvey Barnes,West Bromwich Albion,250000,Wypożyczenie,GB2,2018,32000000,31750000
Richie Towell,Rotherham United,200000,Wypożyczenie,GB2,2018,200000,0
Remi Matthews,Bolton Wanderers,200000,Wypożyczenie,GB2,2018,350000,150000
Marek Rodak,Rotherham United,100000,Wypożyczenie,GB2,2018,3000000,2900000
Zak Vyner,Rotherham United,100000,Wypożyczenie,GB2,2018,2000000,1900000
Christian Doidge,Bolton Wanderers,0,Wypożyczenie,GB2,2018,450000,450000
Mitchel Candlin,Blackburn Rovers,0,Wypożyczenie,GB2,2018,0,0
Rowan Roache,Derby County,0,Wypożyczenie,GB2,2018,0,0
Lee Tomlin,Peterborough United,2000000,Wypożyczenie,GB3,2018,0,-2000000
Zach Clough,AFC Rochdale,2000000,Wypożyczenie,GB3,2018,350000,-1650000
Jacob Butterfield,Bradford City,2000000,Wypożyczenie,GB3,2018,0,-2000000
Joe Mason,FC Portsmouth,1000000,Wypożyczenie,GB3,2018,250000,-750000
David Meyler,Coventry City,1000000,Wypożyczenie,GB3,2018,0,-1000000
Jerome Sinclair,Oxford United,1000000,Wypożyczenie,GB3,2018,0,-1000000
Jerome Sinclair,AFC Sunderland,1000000,Wypożyczenie,GB3,2018,0,-1000000
Jamie Ward,Charlton Athletic,1000000,Wypożyczenie,GB3,2018,0,-1000000
Alex Baptiste,Luton Town,1000000,Wypożyczenie,GB3,2018,0,-1000000
Jason Cummings,Peterborough United,800000,Wypożyczenie,GB3,2018,900000,100000
Jason Cummings,Luton Town,800000,Wypożyczenie,GB3,2018,900000,100000
Max Power,AFC Sunderland,750000,Wypożyczenie,GB3,2018,1000000,250000
Stephen Henderson,Wycombe Wanderers,750000,Wypożyczenie,GB3,2018,300000,-450000
Leonardo Lopes,FC Gillingham,750000,Wypożyczenie,GB3,2018,2000000,1250000
Stuart O'Keefe,Plymouth Argyle,750000,Wypożyczenie,GB3,2018,400000,-350000
Jason Holt,Fleetwood Town,750000,Wypożyczenie,GB3,2018,450000,-300000
Lewis Morgan,AFC Sunderland,750000,Wypożyczenie,GB3,2018,6000000,5250000
Cauley Woodrow,FC Barnsley,750000,Wypożyczenie,GB3,2018,1000000,250000
Ahmed Kashi,Oxford United,700000,Wypożyczenie,GB3,2018,300000,-400000
Greg Docherty,Shrewsbury Town,600000,Wypożyczenie,GB3,2018,900000,300000
Danny Lafferty,Peterborough United,500000,Wypożyczenie,GB3,2018,50000,-450000
Devante Cole,Burton Albion,500000,Wypożyczenie,GB3,2018,600000,100000
Chris Maxwell,Charlton Athletic,500000,Wypożyczenie,GB3,2018,300000,-200000
Aaron Ramsdale,AFC Wimbledon,500000,Wypożyczenie,GB3,2018,38000000,37500000
Tommy Spurr,Fleetwood Town,500000,Wypożyczenie,GB3,2018,0,-500000
Ricky Holmes,FC Gillingham,500000,Wypożyczenie,GB3,2018,0,-500000
Ricky Holmes,Oxford United,500000,Wypożyczenie,GB3,2018,0,-500000
Matt Jarvis,FC Walsall,500000,Wypożyczenie,GB3,2018,0,-500000
George Thomas,Scunthorpe United,500000,Wypożyczenie,GB3,2018,400000,-100000
David Wheeler,FC Portsmouth,500000,Wypożyczenie,GB3,2018,250000,-250000
David Wheeler,Milton Keynes Dons,500000,Wypożyczenie,GB4,2018,250000,-250000
Tony McMahon,Scunthorpe United,500000,Wypożyczenie,GB3,2018,0,-500000
Connor Randall,AFC Rochdale,500000,Wypożyczenie,GB3,2018,450000,-50000
Fred Onyedinma,Wycombe Wanderers,500000,Wypożyczenie,GB3,2018,600000,100000
Harry Bunn,Southend United,500000,Wypożyczenie,GB3,2018,0,-500000
Joel Coleman,Shrewsbury Town,500000,Wypożyczenie,GB3,2018,300000,-200000
Charlie Colkett,Shrewsbury Town,400000,Wypożyczenie,GB3,2018,300000,-100000
Graham Burke,FC Gillingham,350000,Wypożyczenie,GB3,2018,275000,-75000
Billy King,FC Gillingham,350000,Wypożyczenie,GB3,2018,150000,-200000
Josh Clarke,Burton Albion,350000,Wypożyczenie,GB3,2018,200000,-150000
Jack Payne,Bradford City,350000,Wypożyczenie,GB3,2018,350000,0
Samir Carruthers,Oxford United,350000,Wypożyczenie,GB3,2018,0,-350000
Kyle Dempsey,Peterborough United,350000,Wypożyczenie,GB3,2018,450000,100000
David Ball,Bradford City,300000,Wypożyczenie,GB3,2018,350000,50000
Joseph Dodoo,FC Blackpool,250000,Wypożyczenie,GB3,2018,300000,50000
Stephen Humphrys,Scunthorpe United,250000,Wypożyczenie,GB3,2018,700000,450000
Viv Solomon-Otabor,FC Portsmouth,250000,Wypożyczenie,GB3,2018,300000,50000
Tom Pearce,Scunthorpe United,250000,Wypożyczenie,GB3,2018,300000,50000
Andy Lonergan,AFC Rochdale,250000,Wypożyczenie,GB3,2018,200000,-50000
Iké Ugbo,Scunthorpe United,250000,Wypożyczenie,GB3,2018,4000000,3750000
Ben Purrington,Charlton Athletic,250000,Wypożyczenie,GB3,2018,450000,200000
Ben Purrington,AFC Wimbledon,250000,Wypożyczenie,GB3,2018,450000,200000
Mike-Steven Bähre,FC Barnsley,250000,Wypożyczenie,GB3,2018,300000,50000
Ethan Ebanks-Landell,AFC Rochdale,250000,Wypożyczenie,GB3,2018,250000,0
Josh Emmanuel,Shrewsbury Town,200000,Wypożyczenie,GB3,2018,250000,50000
Oscar Threlkeld,Plymouth Argyle,200000,Wypożyczenie,GB3,2018,200000,0
Conor Chaplin,Coventry City,200000,Wypożyczenie,GB3,2018,1000000,800000
Ben Thompson,FC Portsmouth,200000,Wypożyczenie,GB3,2018,400000,200000
Michael Ihiekwe,Accrington Stanley,150000,Wypożyczenie,GB3,2018,500000,350000
Scott Laird,FC Walsall,150000,Wypożyczenie,GB3,2018,0,-150000
Adam King,Peterborough United,150000,Wypożyczenie,GB3,2018,0,-150000
Jack Bonham,Bristol Rovers,100000,Wypożyczenie,GB3,2018,500000,400000
Tyler Denton,Peterborough United,100000,Wypożyczenie,GB3,2018,0,-100000
Jorge Grant,Luton Town,100000,Wypożyczenie,GB3,2018,400000,300000
Jorge Grant,Mansfield Town,100000,Wypożyczenie,GB4,2018,400000,300000
Callum Guy,FC Blackpool,75000,Wypożyczenie,GB3,2018,75000,0
Tyler Garratt,AFC Wimbledon,75000,Wypożyczenie,GB3,2018,25000,-50000
Tom King,AFC Wimbledon,50000,Wypożyczenie,GB3,2018,200000,150000
Stefan Payne,Shrewsbury Town,0,Wypożyczenie,GB3,2018,0,0
Lloyd Isgrove,FC Portsmouth,0,Wypożyczenie,GB3,2018,200000,200000
Joe Martin,Bristol Rovers,0,Wypożyczenie,GB3,2018,0,0
Joe Bunney,AFC Rochdale,0,Wypożyczenie,GB3,2018,0,0
Joe Bunney,FC Blackpool,0,Wypożyczenie,GB3,2018,0,0
Jermaine Anderson,Doncaster Rovers,0,Wypożyczenie,GB3,2018,0,0
Connor Ogilvie,FC Gillingham,0,Wypożyczenie,GB3,2018,350000,350000
Luke Armstrong,Accrington Stanley,0,Wypożyczenie,GB3,2018,150000,150000
Nick Anderton,Accrington Stanley,0,Wypożyczenie,GB3,2018,200000,200000
Christian,Fleetwood Town,0,Wypożyczenie,GB3,2018,0,0
Tyrese Campbell,Shrewsbury Town,0,Wypożyczenie,GB3,2018,3000000,3000000
Luke Charman,Accrington Stanley,0,Wypożyczenie,GB3,2018,0,0
Harry Burgoyne,Plymouth Argyle,0,Wypożyczenie,GB3,2018,150000,150000
Jake Flannigan,Burton Albion,0,Wypożyczenie,GB3,2018,0,0
Alex Bradley,Burton Albion,0,Wypożyczenie,GB3,2018,0,0
Paudie O'Connor,FC Blackpool,0,Wypożyczenie,GB3,2018,150000,150000
Paudie O'Connor,Bradford City,0,Wypożyczenie,GB3,2018,150000,150000
Charlie Fox,Wycombe Wanderers,0,Wypożyczenie,GB3,2018,175000,175000
Lewis O'Brien,Bradford City,0,Wypożyczenie,GB3,2018,8000000,8000000
Brad Collins,Burton Albion,0,Wypożyczenie,GB3,2018,900000,900000
Connor Hall,Accrington Stanley,0,Wypożyczenie,GB3,2018,0,0
Connor Johnson,FC Walsall,0,Wypożyczenie,GB3,2018,0,0
Jack Fitzwater,FC Walsall,0,Wypożyczenie,GB3,2018,550000,550000
Corey Blackett-Taylor,FC Walsall,0,Wypożyczenie,GB3,2018,300000,300000
Randell Williams,Wycombe Wanderers,0,Wypożyczenie,GB3,2018,300000,300000
Tahvon Campbell,FC Gillingham,0,Wypożyczenie,GB3,2018,0,0
Shawn McCoulsky,Southend United,0,Wypożyczenie,GB3,2018,0,0
Matty Platt,Accrington Stanley,0,Wypożyczenie,GB3,2018,100000,100000
Magnus Norman,AFC Rochdale,0,Wypożyczenie,GB3,2018,0,0
Sherwin Seedorf,Bradford City,0,Wypożyczenie,GB3,2018,0,0
Nicky Ajose,Mansfield Town,750000,Wypożyczenie,GB4,2018,0,-750000
Jordan Lyden,Oldham Athletic,500000,Wypożyczenie,GB4,2018,400000,-100000
Mark O'Hara,Lincoln City,450000,Wypożyczenie,GB4,2018,500000,50000
Marvin Sordell,Northampton Town,400000,Wypożyczenie,GB4,2018,0,-400000
Ben Pringle,Grimsby Town,350000,Wypożyczenie,GB4,2018,0,-350000
Ben Pringle,Tranmere Rovers,350000,Wypożyczenie,GB4,2018,0,-350000
Aaron Taylor-Sinclair,Crewe Alexandra,250000,Wypożyczenie,GB4,2018,0,-250000
Tyrone Barnett,Cheltenham Town,250000,Wypożyczenie,GB4,2018,0,-250000
Luke McCullough,Tranmere Rovers,250000,Wypożyczenie,GB4,2018,50000,-200000
Rob Milsom,Notts County,250000,Wypożyczenie,GB4,2018,250000,0
Ryan Sweeney,Mansfield Town,250000,Wypożyczenie,GB4,2018,400000,150000
Matty Willock,Crawley Town,250000,Wypożyczenie,GB4,2018,250000,0
Adam Campbell,Carlisle United,250000,Wypożyczenie,GB4,2018,0,-250000
Gethin Jones,Mansfield Town,250000,Wypożyczenie,GB4,2018,300000,50000
Alex Jones,Cambridge United,200000,Wypożyczenie,GB4,2018,0,-200000
Shay McCartan,Lincoln City,200000,Wypożyczenie,GB4,2018,100000,-100000
Jordan Tillson,Cheltenham Town,150000,Wypożyczenie,GB4,2018,350000,200000
Caolan Lavery,FC Bury,150000,Wypożyczenie,GB4,2018,0,-150000
Rhys Healey,Milton Keynes Dons,150000,Wypożyczenie,GB4,2018,3000000,2850000
Tom Field,Cheltenham Town,150000,Wypożyczenie,GB4,2018,75000,-75000
Franklyn Akammadu,Tranmere Rovers,150000,Wypożyczenie,GB4,2018,50000,-100000
Kieron Morris,Tranmere Rovers,150000,Wypożyczenie,GB4,2018,150000,0
Piero Mingoia,FC Morecambe,150000,Wypożyczenie,GB4,2018,0,-150000
Louis Dodds,Port Vale FC,150000,Wypożyczenie,GB4,2018,0,-150000
Lee Angol,Lincoln City,150000,Wypożyczenie,GB4,2018,150000,0
Sam Slocombe,Lincoln City,125000,Wypożyczenie,GB4,2018,0,-125000
Ben Kennedy,Newport County,125000,Wypożyczenie,GB4,2018,75000,-50000
Chiedozie Ogbene,Exeter City,100000,Wypożyczenie,GB4,2018,2000000,1900000
Joe Maguire,Crawley Town,100000,Wypożyczenie,GB4,2018,100000,0
Kevin O'Connor,Crewe Alexandra,100000,Wypożyczenie,GB4,2018,50000,-50000
Ilias Chair,FC Stevenage,100000,Wypożyczenie,GB4,2018,10000000,9900000
Donovan Wilson,Exeter City,100000,Wypożyczenie,GB4,2018,100000,0
Danny Rowe,Lincoln City,100000,Wypożyczenie,GB4,2018,150000,50000
Botti Biabi,Macclesfield Town FC,100000,Wypożyczenie,GB4,2018,0,-100000
Mathew Hudson,FC Bury,100000,Wypożyczenie,GB4,2018,0,-100000
Liam Mandeville,FC Morecambe,100000,Wypożyczenie,GB4,2018,0,-100000
Kristian Dennis,Grimsby Town,100000,Wypożyczenie,GB4,2018,350000,250000
Callum Roberts,Colchester United,75000,Wypożyczenie,GB4,2018,100000,25000
Aaron Collins,Colchester United,75000,Wypożyczenie,GB4,2018,600000,525000
Sid Nelson,Swindon Town,75000,Wypożyczenie,GB4,2018,0,-75000
Sid Nelson,Tranmere Rovers,75000,Wypożyczenie,GB4,2018,0,-75000
Enes Mahmutovic,Yeovil Town,75000,Wypożyczenie,GB4,2018,250000,175000
Jamie Sterry,Crewe Alexandra,75000,Wypożyczenie,GB4,2018,75000,0
Jack Sowerby,Carlisle United,50000,Wypożyczenie,GB4,2018,50000,0
Fiacre Kelleher,Macclesfield Town FC,50000,Wypożyczenie,GB4,2018,50000,0
Dylan Mottley-Henry,Tranmere Rovers,50000,Wypożyczenie,GB4,2018,0,-50000
Mark Cullen,Carlisle United,0,Wypożyczenie,GB4,2018,0,0
Charlie Raglan,Cheltenham Town,0,Wypożyczenie,GB4,2018,250000,250000
Omari Patrick,Yeovil Town,0,Wypożyczenie,GB4,2018,100000,100000
Luke Hendrie,Grimsby Town,0,Wypożyczenie,GB4,2018,250000,250000
Regan Poole,Newport County,0,Wypożyczenie,GB4,2018,400000,400000
Calum Dyson,FC Stevenage,0,Wypożyczenie,GB4,2018,0,0
Reece Cole,Yeovil Town,0,Wypożyczenie,GB4,2018,0,0
Reece Cole,Macclesfield Town FC,0,Wypożyczenie,GB4,2018,0,0
Timi Max Elsnik,Northampton Town,0,Wypożyczenie,GB4,2018,1000000,1000000
Timi Max Elsnik,Mansfield Town,0,Wypożyczenie,GB4,2018,1000000,1000000
Adam Crookes,Lincoln City,0,Wypożyczenie,GB4,2018,0,0
Adam Crookes,Port Vale FC,0,Wypożyczenie,GB4,2018,0,0
Sam Jones,Cheltenham Town,0,Wypożyczenie,GB4,2018,0,0
Malachi Napa,Macclesfield Town FC,0,Wypożyczenie,GB4,2018,0,0
Richie Bennett,FC Morecambe,0,Wypożyczenie,GB4,2018,0,0
Kyle Howkins,Port Vale FC,0,Wypożyczenie,GB4,2018,0,0
Sam Dalby,FC Morecambe,0,Wypożyczenie,GB4,2018,0,0
Corey Whelan,Crewe Alexandra,0,Wypożyczenie,GB4,2018,100000,100000
Harvey Gilmour,Tranmere Rovers,0,Wypożyczenie,GB4,2018,0,0
George Cox,Northampton Town,0,Wypożyczenie,GB4,2018,900000,900000
Jaden Brown,Exeter City,0,Wypożyczenie,GB4,2018,300000,300000
Charlie Cooper,Newport County,0,Wypożyczenie,GB4,2018,0,0
Dara O'Shea,Exeter City,0,Wypożyczenie,GB4,2018,5000000,5000000
Abo Eisa,Colchester United,0,Wypożyczenie,GB4,2018,0,0
Elijah Adebayo,FC Stevenage,0,Wypożyczenie,GB4,2018,5000000,5000000
Elijah Adebayo,Swindon Town,0,Wypożyczenie,GB4,2018,5000000,5000000
Callum Whelan,Port Vale FC,0,Wypożyczenie,GB4,2018,0,0
Joe Fryer,Carlisle United,0,Wypożyczenie,GB4,2018,0,0
Matt Worthington,Forest Green Rovers,0,Wypożyczenie,GB4,2018,0,0
Paul McKay,FC Morecambe,0,Wypożyczenie,GB4,2018,0,0
Ali Koiki,Swindon Town,0,Wypożyczenie,GB4,2018,0,0
Joe Powell,Northampton Town,0,Wypożyczenie,GB4,2018,500000,500000
Alex Iacovitti,Oldham Athletic,0,Wypożyczenie,GB4,2018,450000,450000
Josef Yarney,FC Morecambe,0,Wypożyczenie,GB4,2018,0,0
Kellan Gordon,Lincoln City,0,Wypożyczenie,GB4,2018,0,0
Zak Dearnley,Oldham Athletic,0,Wypożyczenie,GB4,2018,0,0
Vashon Neufville,Newport County,0,Wypożyczenie,GB4,2018,125000,125000
Shamal George,Tranmere Rovers,0,Wypożyczenie,GB4,2018,325000,325000
Jamie Barjonas,FC Bury,0,Wypożyczenie,GB4,2018,0,0
Steven Alzate,Swindon Town,0,Wypożyczenie,GB4,2018,4000000,4000000
Moses Makasi,FC Stevenage,0,Wypożyczenie,GB4,2018,200000,200000
Aden Baldwin,Cheltenham Town,0,Wypożyczenie,GB4,2018,0,0
Ashley Nadesan,Carlisle United,0,Wypożyczenie,GB4,2018,0,0
Jordan Gibson,FC Stevenage,0,Wypożyczenie,GB4,2018,100000,100000
Lewis Hardcastle,Port Vale FC,0,Wypożyczenie,GB4,2018,0,0
Sam Graham,Oldham Athletic,0,Wypożyczenie,GB4,2018,25000,25000
Joe Piggott,FC Morecambe,0,Wypożyczenie,GB4,2018,0,0
Kelsey Mooney,Cheltenham Town,0,Wypożyczenie,GB4,2018,0,0
Toby Edser,Port Vale FC,0,Wypożyczenie,GB4,2018,0,0
Bernard Mensah,Lincoln City,0,Wypożyczenie,GB4,2018,0,0
Ben House,Swindon Town,0,Wypożyczenie,GB4,2018,100000,100000
Callum Maycock,Macclesfield Town FC,0,Wypożyczenie,GB4,2018,0,0
Mark Harris,Newport County,0,Wypożyczenie,GB4,2018,1000000,1000000
Mark Harris,Port Vale FC,0,Wypożyczenie,GB4,2018,1000000,1000000
Harry McKirdy,Newport County,0,Wypożyczenie,GB4,2018,225000,225000
Keston Davies,Notts County,0,Wypożyczenie,GB4,2018,75000,75000
Alex Pattison,Yeovil Town,0,Wypożyczenie,GB4,2018,200000,200000
Sam Stubbs,Notts County,0,Wypożyczenie,GB4,2018,250000,250000
Nathan McGinley,Forest Green Rovers,0,Wypożyczenie,GB4,2018,375000,375000
Ben Hall,Notts County,0,Wypożyczenie,GB4,2018,50000,50000
Luke Woolfenden,Swindon Town,0,Wypożyczenie,GB4,2018,500000,500000
Ben Morris,Forest Green Rovers,0,Wypożyczenie,GB4,2018,0,0
